,Unnamed: 0,Time,Fan Control #1,Fan Control #2,Fan Control #3,Fan Control #4,Fan Control #5,Fan Control #6,CPU VCore,Voltage #2,AVCC,3VCC,Voltage #5,Voltage #6,Voltage #7,3VSB,VBAT,VTT,Voltage #11,Voltage #12,Voltage #13,Voltage #14,Voltage #15,CPU Core,Temperature #1,Temperature #2,Temperature #3,Temperature #4,Temperature #5,Temperature #6,Fan #1,Fan #2,CPU Core #1,CPU Core #2,CPU Core #3,CPU Core #4,CPU Total,CPU Core #1.1,CPU Core #2.1,CPU Core #3.1,CPU Core #4.1,CPU Package,CPU Core #1.2,CPU Core #2.2,CPU Core #3.2,CPU Core #4.2,CPU Package.1,CPU Cores,CPU Graphics,CPU DRAM,Bus Speed,Memory,Used Memory,Available Memory,GPU Core,GPU Memory,GPU VRM Core,GPU VRM Memory #1,GPU VRM Memory #2,GPU Hot Spot,GPU Total,GPU Fan,GPU Core.1,GPU Memory.1,GPU SOC,GPU Core.2,GPU Memory.2,GPU SOC.1,GPU Core.3,GPU Memory.3,GPU Fan.1,Remaining Life,Total Bytes Written,Used Space,Temperature,Write Amplification,Remaining Life.1,Total Bytes Written.1,Used Space.1,Temperature.1,Write Amplification.1
1733,1733,2022-03-19 18:38:45-04:00,80.78432,100,49.80392,49.80392,49.80392,49.80392,0.56,1.016,3.40800023,3.40800023,1.0,0.160000011,0.992000043,3.40800023,3.2,0.984,0.15200001,0.128,0.144000009,0.128,0.136,24,26.5,117,26.5,110,109,109,1654.41174,2180.937,24.6153831,30.76923,27.6923065,27.6923065,27.6923065,21,23,24,23,25,3291.75317,3291.75317,3291.75317,3291.75317,18.5058842,13.59833,0,1.31278825,99.7501,50.0047836,7.97036,7.968834,53,54,0,0,0,53,42,0,1055,1750,379,0.9620001,0.85,0.91200006,24,9,0,99,2036.2843,84.32165,25,1.51449037,100,1111.71118,69.1098557,26,1.52003574
1734,1734,2022-03-19 18:38:46-04:00,80.78432,100,49.80392,49.80392,49.80392,49.80392,0.552000046,1.016,3.40800023,3.40800023,1.0,0.160000011,0.992000043,3.40800023,3.2,0.984,0.15200001,0.128,0.144000009,0.128,0.136,24,26.5,117,26.5,110,109,109,1644.33618,2188.00659,37.5,43.75,48.4375,48.4375,44.53125,23,22,21,21,24,3291.75244,3291.75244,3291.75244,3291.75244,21.3376369,17.13973,0,1.29942191,99.75007,50.09851,7.985298,7.95389557,53,54,0,0,0,54,35,0,938,1750,226,0.775000036,0.85,0.818,10,4,0,99,2036.2843,84.32165,25,1.51449037,100,1111.71118,69.1098557,26,1.52003574
1735,1735,2022-03-19 18:38:47-04:00,80.78432,100,49.80392,49.80392,49.80392,49.80392,0.552000046,1.016,3.40800023,3.40800023,1.0,0.160000011,0.992000043,3.40800023,3.2,0.984,0.15200001,0.128,0.144000009,0.128,0.136,24,26.5,117,26.5,110,109,109,1652.38684,2180.937,36.9230728,52.30769,24.6153831,52.30769,41.53846,19,23,22,20,25,3291.754,3291.754,3291.754,3491.25415,20.9658985,16.7658825,0,1.267817,99.75012,50.0982437,7.985256,7.95393753,54,54,0,0,0,54,32,0,983,1750,306,0.9620001,0.85,0.818,18,4,0,99,2036.2843,84.32165,25,1.51449037,100,1111.71118,69.1098557,26,1.52003574
1736,1736,2022-03-19 18:38:48-04:00,80.78432,100,49.80392,49.80392,49.80392,49.80392,0.528,1.016,3.40800023,3.40800023,1.0,0.160000011,0.992000043,3.40800023,3.2,0.984,0.15200001,0.128,0.144000009,0.128,0.136,24,26.5,117,26.5,110,109,109,1652.38684,2188.00659,18.75,34.375,43.75,42.1875,34.765625,20,22,22,21,24,3291.7522,3291.7522,3291.7522,3291.7522,20.2135048,15.3874435,0,1.23691142,99.75007,50.0981,7.98523331,7.95396042,53,54,0,0,0,53,32,0,787,1634,423,0.8,0.85,0.8,38,6,0,99,2036.28845,84.3221,25,1.51449,100,1111.712,69.1098557,26,1.52003491
1737,1737,2022-03-19 18:38:49-04:00,80.78432,100,49.80392,49.80392,49.80392,49.80392,0.552000046,1.016,3.40800023,3.40800023,1.0,0.15200001,0.992000043,3.40800023,3.2,0.992000043,0.15200001,0.128,0.144000009,0.128,0.136,24,26.5,117,26.5,110,109,109,1644.33618,2180.937,30.76923,35.384613,41.53846,39.9999962,36.9230728,19,23,22,22,24,3291.75439,3291.75439,3291.75439,3291.75439,20.2135067,15.5323715,0,1.23402035,99.75013,50.09815,7.985241,7.953953,54,54,0,0,0,54,31,0,893,1750,163,0.9620001,0.85,0.818,6,2,0,99,2036.28845,84.3221,25,1.51449,100,1111.712,69.1098557,26,1.52003491
1738,1738,2022-03-19 18:38:50-04:00,80.78432,100,49.80392,49.80392,49.80392,49.80392,0.528,1.016,3.40800023,3.40800023,1.0,0.15200001,0.992000043,3.40800023,3.2,0.984,0.15200001,0.128,0.144000009,0.128,0.136,24,26.5,117,26.5,110,109,109,1650.3667,2184.466,14.0625,34.375,40.625,42.1875,32.8125,19,22,21,23,24,3291.75244,3291.75244,3291.75244,3291.75244,20.35551,15.0047235,0,1.23930454,99.75007,50.10387,7.98615265,7.953041,53,54,0,0,0,53,30,0,789,1744,267,0.775000036,0.85,0.8,19,4,0,99,2036.28845,84.3221,25,1.51449,100,1111.712,69.1098557,26,1.52003491
1739,1739,2022-03-19 18:38:51-04:00,80.78432,100,49.80392,49.80392,49.80392,49.80392,0.496000022,1.016,3.40800023,3.40800023,1.0,0.160000011,0.992000043,3.40800023,3.2,0.984,0.15200001,0.128,0.144000009,0.128,0.136,23,26.0,117,26.5,110,109,109,1662.56152,2180.937,14.0625,31.25,43.75,48.4375,34.375,19,24,20,20,24,3291.75366,3291.75366,3291.75366,3291.75366,20.32289,14.7348471,0,1.23817265,99.75011,50.0993958,7.9854393,7.95375443,53,54,0,0,0,53,31,0,789,1736,267,0.775000036,0.85,0.8,20,4,0,99,2036.28845,84.3221,25,1.51449,100,1111.712,69.1098557,26,1.52003491
1740,1740,2022-03-19 18:38:52-04:00,80.78432,100,49.80392,49.80392,49.80392,49.80392,0.504,1.016,3.40800023,3.40800023,1.0,0.160000011,0.992000043,3.40800023,3.2,0.992000043,0.15200001,0.128,0.144000009,0.128,0.136,23,26.5,117,26.5,110,109,109,1644.33618,2184.466,14.0625,23.4375,40.625,39.0625,29.296875,23,22,21,19,24,3291.754,3291.754,3291.754,3291.754,20.2707348,14.8231544,0,1.23741353,99.75012,50.1005173,7.98561859,7.953575,53,54,0,0,0,54,34,0,788,1702,389,0.775000036,0.85,0.8,30,6,0,99,2036.28845,84.3221,25,1.51449,100,1111.712,69.1098557,26,1.52003491
