,Time,Fan Control #1,Fan Control #2,Fan Control #3,Fan Control #4,Fan Control #5,Fan Control #6,Fan Control #7,CPU VCore,Voltage #2,AVCC,3VCC,Voltage #5,Voltage #6,Voltage #7,3VSB,VBAT,VTT,Voltage #11,Voltage #12,Voltage #13,Voltage #14,Voltage #15,Temperature #1,Temperature #2,Temperature #3,Temperature #4,Temperature #5,Temperature #6,Fan #2,Fan #3,CPU Core #1,CPU Core #2,CPU Core #3,CPU Core #4,CPU Core #5,CPU Core #6,CPU Total,CPU Core #1.1,CPU Core #2.1,CPU Core #3.1,CPU Core #4.1,CPU Core #5.1,CPU Core #6.1,CPU Package,CPU Core #1.2,CPU Core #2.2,CPU Core #3.2,CPU Core #4.2,CPU Core #5.2,CPU Core #6.2,CPU Package.1,CPU Cores,CPU Graphics,CPU DRAM,Bus Speed,Memory,Used Memory,Available Memory,GPU Core,GPU Memory,GPU VRM Core,GPU VRM Memory #1,GPU VRM Memory #2,GPU Hot Spot,GPU Total,GPU Fan,GPU Core.1,GPU Memory.1,GPU SOC,GPU Core.2,GPU Memory.2,GPU SOC.1,GPU Core.3,GPU Memory.3,GPU Fan.1,Remaining Life,Total Bytes Written,Temperature,Write Amplification,Temperature.1,Used Space
14559,2022-03-21 17:45:21,60.0,100,100,100,100,100,100,0.952,1.008,3.37600017,3.3920002,0.992000043,0.984,1.008,3.37600017,3.26400018,0.496000022,0.6,0.528,0.992000043,1.016,1.016,25.5,27,25.5,15,23,25,1912.18127,2173.913,17.1875,16.40625,17.1875,6.25,10.15625,33.59375,16.796875,24,28,23,24,23,24,28,4005.52441,4005.52441,4005.52441,4005.52441,4005.52441,4005.52441,23.6863174,21.4245071,0,1.69287825,100.138107,56.94822,9.061615,6.85041046,46,48,0,0,0,46,48,0,953,1750,862,0.8,0.85,0.91200006,54,23,0,100,1113.12048,25.0,1.51965964,37.0,31.7180481
14560,2022-03-21 17:45:21,60.0,100,100,100,100,100,100,0.776,1.008,3.3920002,3.40800023,0.992000043,0.984,1.008,3.37600017,3.26400018,0.496000022,0.6,0.528,0.992000043,1.008,1.016,25.5,27,25.5,15,23,25,1912.18127,2173.913,5.46875,14.84375,7.03125,14.0625,4.6875,6.25,8.723956,22,24,22,22,22,22,24,4005.52441,4005.52441,4005.52441,4005.52441,4005.52441,3705.11,12.30768,10.1488562,0,1.35643554,100.138107,56.8855743,9.051647,6.86037827,47,48,0,0,0,48,45,0,818,1750,905,0.8,0.85,0.818,49,17,0,100,1113.12048,25.0,1.51965964,37.0,31.7180481
14561,2022-03-21 17:45:22,60.0,100,100,100,100,100,100,0.840000033,1.008,3.37600017,3.3920002,0.992000043,0.984,1.008,3.37600017,3.26400018,0.496000022,0.6,0.528,0.992000043,1.008,1.016,26.0,27,25.5,15,23,25,1923.0769,2170.418,9.230768,10.76923,13.0769253,8.4615345,4.615384,4.615384,8.461541,22,23,22,22,22,23,24,4005.52441,4005.52441,4005.52441,4005.52441,4005.52441,4005.52441,14.8926516,12.55873,0,1.47928119,100.138115,56.878624,9.050541,6.86148453,47,50,0,0,0,48,45,0,818,1750,764,0.8,0.85,0.818,48,16,0,100,1113.12048,25.0,1.51965964,37.0,31.7180481
14562,2022-03-21 17:45:24,60.0,100,100,100,100,100,100,0.76000005,1.008,3.37600017,3.3920002,0.992000043,0.984,1.008,3.37600017,3.26400018,0.496000022,0.6,0.528,0.992000043,1.008,1.016,26.0,27,25.5,15,23,25,1934.09741,2166.934,2.30768919,10.0000019,0.7692337,5.384612,2.30768919,4.615384,4.23076725,22,23,22,22,22,22,24,4005.52441,4005.52441,4005.52441,4005.52441,3705.11,4005.52441,11.6393042,9.230971,0,1.29598725,100.138107,56.9032173,9.054455,6.85757065,47,50,0,0,0,49,41,0,806,1750,720,0.8,0.85,0.818,50,16,0,100,1113.12048,25.0,1.51965964,37.0,31.7180481
14563,2022-03-21 17:45:24,60.0,100,100,100,100,100,100,0.944000065,1.008,3.37600017,3.3920002,0.992000043,0.984,1.008,3.37600017,3.26400018,0.496000022,0.6,0.528,0.992000043,1.008,1.016,26.0,27,25.5,15,23,25,1934.09741,2170.418,3.955853,14.0625,5.46875,2.34375,2.34375,3.125,5.21659851,22,23,22,22,21,23,24,4005.52441,4005.52441,4005.52441,4005.52441,4005.52441,4005.52441,13.2434807,10.8366938,0,1.43832958,100.138107,56.9578323,9.063145,6.848881,48,50,0,0,0,49,51,0,812,1750,853,0.775000036,0.85,0.91200006,58,19,0,100,1113.12048,25.0,1.51965964,37.0,31.7180481
14564,2022-03-21 17:45:26,60.0,100,100,100,100,100,100,0.816000044,1.008,3.37600017,3.3920002,0.992000043,0.984,1.008,3.37600017,3.26400018,0.496000022,0.6,0.528,0.992000043,1.008,1.016,26.0,27,25.5,15,23,25,1920.34143,2177.41943,6.899762,8.4615345,3.076923,3.8461566,1.52680874,2.30768919,4.353142,22,23,22,22,22,23,24,4005.52466,4005.52466,4005.52466,4005.52466,4005.52466,4005.52466,11.661376,9.3795,0,1.30298078,100.138123,56.95728,9.063057,6.84896851,48,52,0,0,0,48,42,0,805,1750,815,0.8,0.85,0.818,54,18,0,100,1113.12048,25.0,1.51965964,37.0,31.7180481
14565,2022-03-21 17:45:27,60.0,100,100,100,100,100,100,0.744,1.008,3.37600017,3.3920002,0.992000043,0.984,1.008,3.37600017,3.26400018,0.496000022,0.6,0.528,0.992000043,1.008,1.016,25.5,27,26.0,15,23,25,1923.0769,2170.418,2.34375,15.625,7.03125,5.46875,5.46875,3.125,6.510419,23,24,25,23,29,23,29,4005.52466,4005.52466,4005.52466,4005.52466,4005.52466,4005.52466,13.76425,11.4597435,0,1.46518242,100.138123,56.933403,9.05925751,6.852768,48,50,0,0,0,49,43,0,816,1750,850,0.8,0.85,0.818,53,18,0,100,1113.12048,25.0,1.51965964,37.0,31.7180481
14566,2022-03-21 17:45:28,60.0,100,100,100,100,100,100,0.8,1.008,3.37600017,3.3920002,0.992000043,0.984,1.008,3.37600017,3.26400018,0.496000022,0.6,0.528,0.992000043,1.008,1.016,25.5,27,25.5,15,23,25,1914.89368,2173.913,2.34375,9.375,2.34375,5.46875,3.90625,2.34375,4.296875,23,24,22,22,22,22,25,2904.00464,2904.00464,4005.52344,4005.52344,4005.52344,4005.52344,12.0142689,9.766699,0,1.30625391,100.138084,56.9977036,9.069489,6.842537,48,50,0,0,0,49,55,0,798,1750,1047,0.8,0.85,0.91200006,76,24,0,100,1113.12048,25.0,1.51965964,37.0,31.7180481
14567,2022-03-21 17:45:29,60.0,100,100,100,100,100,100,0.744,1.008,3.37600017,3.3920002,0.992000043,0.984,1.008,3.37600017,3.26400018,0.496000022,0.6,0.528,0.992000043,1.008,1.016,25.5,27,25.5,15,23,25,1925.82031,2177.41943,4.615384,19.23077,6.92307949,10.76923,3.076923,2.30768919,7.820511,23,31,22,24,22,23,31,4005.52515,4005.52515,4005.52515,4005.52515,4005.52515,4005.52515,14.1361723,11.83343,0,1.53476322,100.13813,57.0187263,9.072834,6.83919144,48,52,0,0,0,50,52,0,838,1750,920,0.775000036,0.85,0.91200006,61,20,0,100,1113.12048,25.0,1.51965964,37.0,31.7180481
14568,2022-03-21 17:45:30,60.0,100,100,100,100,100,100,0.960000038,1.008,3.37600017,3.3920002,0.992000043,0.984,1.008,3.37600017,3.26400018,0.496000022,0.6,0.528,0.992000043,1.008,1.016,25.5,27,25.5,15,23,25,1936.87231,2173.913,3.076923,12.3076916,12.3076916,3.8461566,12.3076916,3.8461566,7.94871426,23,25,23,23,22,23,25,4005.52466,4005.52466,2904.00537,4005.52466,4005.52466,4005.52466,14.4819565,12.1921825,0,1.44003582,100.138115,57.0631943,9.07991,6.832115,49,52,0,0,0,50,57,0,806,1750,1080,0.8,0.85,0.91200006,79,27,0,100,1113.12048,25.0,1.51965964,37.0,31.7180481
14569,2022-03-21 17:45:31,60.0,100,100,100,100,100,100,0.960000038,1.008,3.37600017,3.3920002,0.992000043,0.984,1.008,3.37600017,3.26400018,0.496000022,0.6,0.528,0.992000043,1.008,1.016,25.5,27,25.5,15,23,25,1923.0769,2170.418,5.46875,13.28125,7.03125,7.8125,6.25,4.6875,7.421875,23,25,23,24,23,28,28,4005.524,4005.524,4005.524,4005.524,4005.524,4005.524,14.4828358,12.1492329,0,1.56018531,100.1381,57.1865654,9.099541,6.81248474,49,52,0,0,0,50,50,0,816,1750,937,0.8,0.85,0.91200006,65,22,0,100,1113.12048,25.0,1.51965964,37.0,31.7180481
14570,2022-03-21 17:45:32,60.0,100,100,100,100,100,100,0.744,1.008,3.37600017,3.3920002,0.992000043,0.984,1.008,3.37600017,3.26400018,0.496000022,0.6,0.528,0.992000043,1.008,1.016,25.5,27,25.5,15,23,25,1914.89368,2177.41943,2.34375,9.375,4.6875,3.90625,3.125,12.5,5.989581,23,24,23,22,22,22,24,4005.52441,4005.52441,4005.52441,4005.52441,4005.52441,3705.11,12.8253078,10.52369,0,1.42465925,100.138115,57.22679,9.105942,6.80608368,49,52,0,0,0,50,46,0,825,1750,743,0.775000036,0.85,0.818,49,16,0,100,1113.12048,25.0,1.51965964,37.0,31.7180481
14571,2022-03-21 17:45:33,60.0,100,100,100,100,100,100,0.744,1.008,3.37600017,3.3920002,0.992000043,0.984,1.008,3.37600017,3.26400018,0.496000022,0.6,0.528,0.992000043,1.008,1.016,25.5,27,25.5,15,23,25,1925.82031,2177.41943,3.90625,17.1875,6.25,5.46875,2.34375,3.125,6.380206,24,25,32,23,22,23,32,4005.52466,4005.52466,4005.52466,4005.52466,4005.52466,4005.52466,14.5612211,12.2423124,0,1.53947806,100.138115,58.0161743,9.231548,6.680477,49,52,0,0,0,50,46,0,813,1750,839,0.8,0.85,0.818,51,17,0,100,1113.12048,25.0,1.51965964,37.0,31.7180481
14572,2022-03-21 17:45:34,60.0,100,100,100,100,100,100,0.808,1.008,3.37600017,3.3920002,0.992000043,0.984,1.008,3.37600017,3.26400018,0.496000022,0.6,0.528,0.992000043,1.008,1.016,25.5,27,25.5,15,23,25,1925.82031,2170.418,3.125,20.3125,5.46875,6.25,3.125,4.6875,7.161456,23,24,22,23,22,22,25,4005.52466,4005.52466,3705.11035,4005.52466,4005.52466,3705.11035,13.4075279,11.14752,0,1.46215963,100.138115,57.3432579,9.124474,6.787552,49,52,0,0,0,51,53,0,827,1750,896,0.775000036,0.85,0.91200006,60,20,0,100,1113.12048,25.0,1.51965964,37.0,31.7180481
14573,2022-03-21 17:45:35,60.0,100,100,100,100,100,100,0.8,1.008,3.37600017,3.3920002,0.992000043,0.984,1.008,3.37600017,3.26400018,0.496000022,0.6,0.528,0.992000043,1.008,1.016,25.5,27,25.5,15,23,25,1936.87231,2170.418,3.90625,10.9375,4.6875,6.25,3.125,3.90625,5.46875,23,24,24,24,22,23,24,4005.52441,4005.52441,4005.52441,4005.52441,4005.52441,4005.52441,13.6222067,11.3262215,0,1.4886384,100.138115,57.5374451,9.155373,6.756653,50,52,0,0,0,50,57,0,800,1750,1056,0.8,0.85,0.91200006,77,24,0,100,1113.12048,25.0,1.51965964,37.0,31.7180481
14574,2022-03-21 17:45:36,60.0,100,100,100,100,100,100,0.960000038,1.008,3.37600017,3.3920002,0.992000043,0.984,1.008,3.37600017,3.26400018,0.496000022,0.6,0.528,0.992000043,1.008,1.016,25.5,27,25.5,15,23,25,1923.0769,2170.418,3.858173,20.8653812,6.947112,4.6875,0.78125,2.30768919,6.57451725,23,23,23,22,22,23,24,4005.52417,4005.52417,2904.00513,2904.00513,4005.52417,4005.52417,13.3241148,11.1188679,0,1.48784363,100.138107,57.39257,9.13232,6.779705,50,52,0,0,0,50,51,0,802,1750,979,0.8,0.85,0.91200006,69,22,0,100,1113.12048,25.0,1.51965964,37.0,31.7180481
14575,2022-03-21 17:45:37,60.0,100,100,100,100,100,100,0.952,1.008,3.37600017,3.3920002,0.992000043,0.984,1.008,3.37600017,3.26400018,0.496000022,0.6,0.528,0.992000043,1.008,1.016,25.5,27,25.5,15,23,25,1923.0769,2170.418,7.911706,14.2609119,4.76190472,3.125,3.125,5.53075075,6.4525423,22,23,22,22,22,23,24,4005.52441,4005.52441,4005.52441,4005.52441,4005.52441,4005.52441,13.4341564,11.1238041,0,1.48559773,100.138107,57.5678635,9.160213,6.751812,50,52,0,0,0,51,46,0,824,1750,865,0.8,0.85,0.91200006,58,19,0,100,1113.12048,25.0,1.51965964,37.0,31.7180481
14576,2022-03-21 17:45:38,60.0,100,100,100,100,100,100,0.872000039,1.008,3.37600017,3.3920002,0.992000043,0.984,1.008,3.37600017,3.26400018,0.496000022,0.6,0.528,0.992000043,1.008,1.016,25.5,27,25.5,15,23,25,1914.89368,2177.41943,4.6875,13.28125,15.6129837,10.15625,19.53125,2.34375,10.9354973,23,24,22,23,22,23,25,4005.525,4005.525,4005.525,4005.525,4005.525,4005.525,16.1723385,13.8801575,0,1.52036822,100.138123,57.5276833,9.15382,6.75820541,50,54,0,0,0,51,47,0,817,1750,880,0.8,0.85,0.818,58,20,0,100,1113.12048,25.0,1.51965964,37.0,31.7180481
14577,2022-03-21 17:45:39,60.0,100,100,100,100,100,100,0.928000033,1.008,3.3920002,3.40800023,0.992000043,0.984,1.008,3.37600017,3.26400018,0.496000022,0.6,0.528,0.992000043,1.008,1.016,25.5,27,25.5,15,23,25,1912.18127,2170.418,7.03125,14.84375,5.46875,5.46875,3.90625,1.5625,6.380206,23,24,22,22,22,23,24,4005.52441,4005.52441,3705.11,4005.52441,2904.00513,4005.52441,12.93935,10.648984,0,1.4552902,100.138107,57.64717,9.17283249,6.739193,50,52,0,0,0,51,57,0,846,1750,1125,0.8,0.85,0.91200006,84,26,0,100,1113.12048,25.0,1.51965964,37.0,31.7180481
14578,2022-03-21 17:45:40,60.0,100,100,100,100,100,100,0.960000038,1.008,3.37600017,3.3920002,0.992000043,0.984,1.008,3.3920002,3.26400018,0.496000022,0.6,0.528,0.992000043,1.008,1.016,25.5,27,25.5,15,23,25,1923.0769,2166.934,0.7692337,16.9471149,8.59375,6.165862,3.8461566,4.639423,6.82692528,23,25,22,23,22,23,25,4005.52466,4005.52466,4005.52466,4005.52466,4005.52466,4005.52466,14.0800333,11.8722,0,1.53067482,100.138115,57.62147,9.168743,6.74328232,50,54,0,0,0,51,53,0,801,1750,974,0.8,0.85,0.91200006,71,23,0,100,1113.12048,25.0,1.51965964,37.0,31.7180481
14579,2022-03-21 17:45:41,60.0,100,100,100,100,100,100,0.704000056,1.008,3.3920002,3.3920002,0.992000043,0.984,1.008,3.3920002,3.26400018,0.496000022,0.6,0.528,0.992000043,1.008,1.016,25.5,27,25.5,15,23,25,1925.82031,2170.418,3.10096145,17.9447117,3.8461566,3.1129837,5.46875,3.125,6.09976673,22,24,21,22,22,23,24,4005.52368,3404.695,4005.52368,3705.10938,2904.00464,2904.00464,12.7174635,10.3345957,0,1.43879271,100.138092,57.6911125,9.179825,6.73220062,50,52,0,0,0,50,15,0,791,472,160,0.775000036,0.675,0.8,6,4,0,100,1113.12048,25.0,1.51965964,37.0,31.7180481
14580,2022-03-21 17:45:42,60.0,100,100,100,100,100,100,0.9760001,1.008,3.3920002,3.40800023,0.992000043,0.984,1.008,3.3920002,3.26400018,0.496000022,0.6,0.528,0.992000043,1.008,1.016,25.5,27,25.5,15,23,25,1934.09741,2177.41943,10.15625,17.1875,17.96875,7.03125,8.59375,21.875,13.8020811,24,26,23,24,22,24,26,4005.52466,4005.52466,4005.52466,4005.52466,4005.52466,4005.52466,20.6039963,17.67878,0,1.641346,100.138115,58.2813721,9.27374649,6.638279,48,50,0,0,0,48,17,0,792,960,120,0.775000036,0.85,0.8,3,1,0,100,1113.12048,25.0,1.51965964,37.0,31.7180481
14581,2022-03-21 17:45:43,60.0,100,100,100,100,100,100,0.92,1.008,3.3920002,3.40800023,0.992000043,0.984,1.008,3.3920002,3.26400018,0.504,0.6,0.528,0.992000043,1.008,1.016,25.5,27,25.5,15,23,25,1934.09741,2177.41943,6.92307949,9.230768,12.3076916,3.076923,3.076923,28.46154,10.5128288,26,25,23,24,24,30,30,4005.52441,4005.52441,4005.52441,4005.52441,4005.52441,4005.52441,19.45867,16.8128338,0,1.53226745,100.138107,58.777626,9.352711,6.55931473,48,50,0,0,0,48,17,0,792,974,103,0.775000036,0.85,0.8,3,2,0,100,1113.12048,25.0,1.51965964,37.0,31.7180481
14582,2022-03-21 17:45:44,60.0,100,100,100,100,100,100,0.968000054,1.008,3.3920002,3.40800023,0.992000043,0.984,1.008,3.37600017,3.26400018,0.504,0.6,0.528,0.992000043,1.008,1.016,25.5,27,25.5,15,23,25,1923.0769,2170.418,17.96875,25.0248013,19.53125,26.5625,16.40625,28.125,22.2697563,27,27,24,27,24,25,27,4005.52515,4005.52515,4005.52515,4005.52515,4005.52515,4005.52515,27.09943,24.7456646,0,1.74773645,100.13813,59.55689,9.476707,6.435318,47,50,0,0,0,47,21,0,786,202,627,0.8,0.675,0.8,53,1,0,100,1113.12048,25.0,1.51965964,37.0,31.7180481
14583,2022-03-21 17:45:45,60.0,100,100,100,100,100,100,0.992000043,1.008,3.3920002,3.3920002,0.992000043,0.984,1.008,3.3920002,3.26400018,0.496000022,0.6,0.528,0.992000043,1.016,1.016,25.5,27,25.5,15,23,25,1914.89368,2170.418,14.6153812,17.65734,26.1538448,12.3076916,17.8365345,33.8461533,20.4028187,26,26,24,28,28,32,32,4005.524,4005.524,4005.524,4005.524,4005.524,4005.524,26.5700951,24.1270924,0,1.86361539,100.1381,60.6228333,9.64632,6.265705,50,52,0,0,0,51,52,0,792,1750,888,0.775000036,0.85,0.91200006,67,22,0,100,1113.12048,25.0,1.51965964,37.0,31.7180481
14584,2022-03-21 17:45:46,60.0,100,100,100,100,100,100,0.904000044,1.008,3.3920002,3.3920002,0.992000043,0.984,1.008,3.37600017,3.26400018,0.496000022,0.6,0.528,0.992000043,1.008,1.016,25.5,27,25.5,15,23,25,1925.82031,2173.913,9.230768,30.0000019,19.23077,26.9230728,11.5034943,13.8461533,18.4557133,26,32,27,28,28,25,29,4005.525,4005.525,4005.525,4005.525,2904.00537,4005.525,24.3292885,21.9820976,0,1.948623,100.138123,60.66879,9.653633,6.25839233,51,54,0,0,0,53,59,0,1067,1750,988,0.8,0.85,0.91200006,71,28,0,100,1113.12048,25.0,1.51965964,37.0,31.7180481
14585,2022-03-21 17:45:47,60.0,100,100,100,100,100,100,0.9760001,1.008,3.3920002,3.3920002,0.992000043,0.984,1.008,3.37600017,3.26400018,0.496000022,0.6,0.528,0.992000043,1.008,1.016,25.5,27,26.0,15,23,25,1934.09741,2170.418,9.326923,18.4615364,5.384612,14.6153812,10.76923,8.4615345,11.1698809,25,25,23,25,24,25,26,4005.52441,4005.52441,4005.52441,4005.52441,4005.52441,4005.52441,19.2471123,16.9648247,0,1.86338484,100.138115,60.7064247,9.659622,6.25240326,54,54,0,0,0,60,113,402,1660,1750,1185,0.9620001,0.85,0.91200006,71,39,10,100,1113.12048,25.0,1.51965964,37.0,31.7180481
14586,2022-03-21 17:45:48,60.0,100,100,100,100,100,100,0.984,1.008,3.37600017,3.37600017,0.992000043,0.984,1.008,3.3920002,3.26400018,0.496000022,0.6,0.528,0.992000043,1.008,1.008,25.5,27,26.0,15,23,25,1934.09741,2166.934,10.0360575,24.21875,14.8685513,21.9618073,11.7435513,10.9375,15.6277,25,30,24,28,24,26,30,4005.52466,4005.52466,4005.52466,4005.52466,4005.52466,4005.52466,23.0172367,20.69702,0,2.12728739,100.138115,60.83711,9.680416,6.23160934,55,56,0,0,0,62,120,1104,1687,1750,1230,0.9620001,0.85,0.91200006,79,43,29,100,1113.12048,25.0,1.51965964,37.0,31.7180481
14587,2022-03-21 17:45:49,60.0,100,100,100,100,100,100,0.9760001,1.008,3.3920002,3.3920002,0.992000043,0.984,1.008,3.3920002,3.26400018,0.496000022,0.6,0.528,0.992000043,1.008,1.008,25.5,27,26.0,15,23,25,1923.0769,2166.934,13.9663458,19.2548027,13.0769253,16.9230766,16.1538486,7.69230747,14.5112219,24,26,23,25,27,24,27,4005.52368,4005.52368,4005.52368,4005.52368,4005.52368,4005.52368,21.1547184,18.8949776,0,1.99541056,100.138092,60.84689,9.6819725,6.230053,55,56,0,0,0,63,120,1306,1686,1750,1232,0.775000036,0.85,0.91200006,80,44,34,100,1113.12048,25.0,1.51965964,37.0,31.7180481
14588,2022-03-21 17:45:50,60.0,100,100,100,100,100,100,0.992000043,1.008,3.3920002,3.3920002,0.992000043,0.984,1.008,3.3920002,3.26400018,0.496000022,0.6,0.528,0.992000043,1.008,1.016,25.5,27,26.0,15,23,25,1920.34143,2170.418,11.817956,27.70337,17.4479122,19.0476189,14.2609119,18.2539711,18.0886269,26,37,26,29,26,31,37,4005.52563,4005.52563,4005.52563,4005.52563,4005.52563,4005.52563,25.0339527,22.6693363,0,2.19863558,100.138138,61.91259,9.851547,6.060478,55,56,0,0,0,58,47,1403,1117,1540,1028,0.8,0.85,0.8,66,14,36,100,1113.12048,25.0,1.51965964,37.0,31.7180481
14589,2022-03-21 17:45:51,60.0,100,100,100,100,100,100,0.9760001,1.008,3.3920002,3.3920002,0.992000043,0.984,1.008,3.3920002,3.26400018,0.496000022,0.6,0.528,0.992000043,1.008,1.016,25.5,27,26.0,15,23,25,1912.18127,2166.934,13.3680582,24.21875,14.84375,21.1309547,21.1681538,21.875,19.4341125,24,26,24,27,24,25,27,4005.52441,4005.52441,4005.52441,4005.52441,4005.52441,4005.52441,23.4244156,21.1131725,0,2.12755585,100.138107,61.31972,9.75721,6.15481567,56,56,0,0,0,62,114,1455,1659,1750,1163,0.9620001,0.85,0.91200006,71,39,38,100,1113.12048,25.0,1.51965976,37.0,31.7180557
14590,2022-03-21 17:45:52,60.0,100,100,100,100,100,100,0.936000049,1.008,3.3920002,3.3920002,0.992000043,0.984,1.008,3.3920002,3.26400018,0.496000022,0.6,0.528,0.992000043,1.008,1.016,25.5,27,26.0,15,23,25,1912.18127,2170.418,10.8293295,23.4375,10.9375,17.9567337,13.2211571,6.25,13.7720346,25,26,24,26,24,24,26,4005.52466,4005.52466,4005.52466,4005.52466,4005.52466,4005.52466,21.1776867,18.9074516,0,2.014939,100.138115,61.4525871,9.778351,6.13367462,56,56,0,0,0,63,113,1492,1650,1750,1163,0.9620001,0.85,0.91200006,72,38,39,100,1113.12048,25.0,1.51965976,37.0,31.7180557
14591,2022-03-21 17:45:53,60.0,100,100,100,100,100,100,0.9760001,1.0,3.3920002,3.3920002,0.992000043,0.984,1.008,3.37600017,3.26400018,0.496000022,0.6,0.528,0.992000043,1.008,1.008,25.5,27,26.0,15,23,25,1925.82031,2166.934,13.28125,19.53125,17.1875,17.96875,12.5,9.375,14.9739561,28,28,25,28,25,25,28,4005.52417,4005.52417,4005.52417,4005.52417,4005.52417,4005.52417,23.776947,21.43075,0,2.14431858,100.1381,61.54934,9.793747,6.1182785,56,56,0,0,0,62,105,1519,1712,1750,1203,0.9620001,0.85,0.91200006,77,37,39,100,1113.12048,25.0,1.51965976,37.0,31.7180557
14592,2022-03-21 17:45:54,60.0,100,100,100,100,100,100,0.896,1.008,3.3920002,3.3920002,0.992000043,0.984,1.008,3.3920002,3.26400018,0.496000022,0.6,0.528,0.992000043,1.008,1.008,25.5,27,26.0,15,23,25,1923.0769,2166.934,7.8125,24.21875,10.9375,18.75,12.5,13.28125,14.5833311,25,26,23,27,26,24,27,4005.52417,4005.52417,4005.52417,4005.52417,4005.52417,4005.52417,21.8082943,19.5385246,0,2.03145385,100.138107,61.53474,9.791424,6.12060165,56,58,0,0,0,63,117,1544,1677,1750,1226,0.9620001,0.85,0.91200006,82,46,40,100,1113.12048,25.0,1.51965976,37.0,31.7180557
14593,2022-03-21 17:45:55,60.0,100,100,100,100,100,100,0.968000054,1.008,3.3920002,3.37600017,0.992000043,0.984,1.008,3.3920002,3.26400018,0.496000022,0.6,0.528,0.992000043,1.008,1.016,25.5,27,26.0,15,23,25,1934.09741,2170.418,11.71875,25.0,15.625,20.3125,13.28125,13.28125,16.5364571,31,28,30,33,29,31,33,4005.52466,4005.52466,4005.52466,4005.52466,4005.52466,4005.52466,24.26982,21.9279022,0,2.19047856,100.138115,61.80852,9.834988,6.077038,56,58,0,0,0,64,119,1572,1718,1750,1256,0.9620001,0.85,0.91200006,85,45,41,100,1113.12048,25.0,1.51965976,37.0,31.7180557
14594,2022-03-21 17:45:56,60.0,100,100,100,100,100,100,0.896,1.008,3.37600017,3.3920002,0.992000043,0.984,1.008,3.37600017,3.26400018,0.496000022,0.6,0.528,0.992000043,1.008,1.008,25.5,27,26.0,15,23,25,1936.87231,2170.418,7.03125,21.09375,9.375,17.96875,9.375,19.53125,14.0625,26,25,25,27,24,24,27,4005.525,4005.525,4005.525,4005.525,4005.525,4005.525,21.74071,19.4401264,0,2.04316878,100.138123,61.7569542,9.826782,6.085243,56,58,0,0,0,63,107,1598,1657,1750,1211,0.9620001,0.85,0.91200006,76,40,42,100,1113.12048,25.0,1.51965976,37.0,31.7180557
14595,2022-03-21 17:45:57,60.0,100,100,100,100,100,100,0.840000033,1.0,3.37600017,3.3920002,0.992000043,0.984,1.008,3.37600017,3.26400018,0.496000022,0.6,0.528,0.992000043,1.008,1.016,26.0,27,26.0,15,23,25,1920.34143,2170.418,15.3846149,26.9230728,19.9999981,19.9999981,10.76923,18.4615364,18.58974,29,33,25,27,29,26,33,4005.524,4005.524,4005.524,4005.524,4005.524,4005.524,25.2822323,22.9345016,0,2.26673174,100.138092,62.61147,9.962753,5.949272,56,58,0,0,0,62,104,1628,1644,1750,1175,0.95600003,0.85,0.91200006,64,35,42,100,1113.12048,25.0,1.51965976,37.0,31.7180557
14596,2022-03-21 17:45:58,60.0,100,100,100,100,100,100,0.8880001,1.0,3.3920002,3.3920002,0.992000043,0.984,1.008,3.3920002,3.26400018,0.496000022,0.6,0.528,0.992000043,1.008,1.008,25.5,27,26.0,15,23,25,1914.89368,2166.934,13.0769253,21.53846,14.6153812,23.0769215,15.3846149,6.92307949,15.7692375,25,26,24,27,25,24,27,4005.525,4005.525,4005.525,4005.525,4005.525,4005.525,22.676466,20.3847179,0,2.06353331,100.138123,62.00398,9.866089,6.04593658,57,58,0,0,0,63,99,1661,1653,1750,1210,0.9620001,0.85,0.91200006,71,36,43,100,1113.12048,25.0,1.51965976,37.0,31.7180557
14597,2022-03-21 17:45:59,60.0,100,100,100,100,100,100,0.928000033,1.008,3.3920002,3.3920002,0.992000043,0.984,1.008,3.3920002,3.26400018,0.496000022,0.6,0.528,0.992000043,1.008,1.008,25.5,27,26.0,15,23,25,1925.82031,2163.46143,11.5384579,19.23077,15.3846149,23.0769215,11.5384579,16.9230766,16.2820511,25,26,28,27,24,24,28,4005.52441,4005.52441,4005.52441,4005.52441,4005.52441,4005.52441,24.0530968,21.7188416,0,2.16547084,100.138107,62.59335,9.959869,5.952156,56,58,0,0,0,63,112,1695,1633,1750,1151,0.775000036,0.85,0.91200006,71,39,44,100,1113.12048,25.0,1.51965976,37.0,31.7180557
14598,2022-03-21 17:46:00,60.0,100,100,100,100,100,100,0.984,1.0,3.3920002,3.37600017,0.992000043,0.984,1.008,3.37600017,3.26400018,0.496000022,0.6,0.528,0.992000043,1.008,1.016,26.0,27,26.0,15,23,25,1934.09741,2166.934,15.3846149,26.9230728,13.8461533,21.53846,13.8461533,13.0769253,17.4359016,26,28,24,28,24,24,28,4005.523,4005.523,4005.523,4005.523,4005.523,4005.523,21.4762878,19.1777287,0,2.05461335,100.138077,62.276413,9.909439,6.00258636,57,60,0,0,0,63,100,1727,1636,1750,1182,0.9620001,0.85,0.91200006,71,36,45,100,1113.12048,25.0,1.51965976,37.0,31.7180557
14599,2022-03-21 17:46:01,60.0,100,100,100,100,100,100,0.936000049,1.008,3.37600017,3.3920002,0.992000043,0.984,1.008,3.37600017,3.26400018,0.496000022,0.6,0.528,0.992000043,1.008,1.008,26.0,27,26.0,15,23,25,1923.0769,2173.913,4.6875,23.4375,10.15625,15.625,10.15625,8.59375,12.109375,24,27,23,27,24,25,28,4005.52563,4005.52563,4005.52563,4005.52563,4005.52563,4005.52563,21.31174,19.03645,0,2.04011,100.138145,62.4679871,9.939922,5.972103,56,60,0,0,0,63,116,1758,1678,1750,1220,0.9620001,0.85,0.91200006,81,45,46,100,1113.12048,25.0,1.51965976,37.0,31.7180557
14600,2022-03-21 17:46:02,60.0,100,100,100,100,100,100,0.984,1.0,3.37600017,3.3920002,0.992000043,0.984,1.008,3.3920002,3.26400018,0.496000022,0.6,0.528,0.992000043,1.008,1.016,26.0,27,26.0,15,23,25,1920.34143,2170.418,12.3076916,23.84615,9.230768,15.3846149,13.0769253,8.4615345,13.7179432,24,26,25,26,24,25,26,4005.52466,4005.52466,4005.52466,4005.52466,4005.52466,4005.52466,22.5632572,20.24576,0,2.10626459,100.138115,62.4707947,9.940369,5.971657,57,60,0,0,0,64,118,1788,1706,1750,1192,0.9620001,0.85,0.91200006,74,40,47,100,1113.12048,25.0,1.51965976,37.0,31.7180557
14601,2022-03-21 17:46:03,60.0,100,100,100,100,100,100,0.944000065,1.008,3.37600017,3.37600017,0.992000043,0.984,1.008,3.37600017,3.26400018,0.496000022,0.6,0.528,0.992000043,1.008,1.016,26.0,27,26.0,15,23,25,1912.18127,2177.41943,17.0432682,21.875,19.53125,16.40625,13.0889416,20.9495182,18.1490364,25,26,24,27,25,26,27,4005.52417,4005.52417,4005.52417,4005.52417,4005.52417,4005.52417,24.4870338,22.1818657,0,2.13810515,100.138107,62.7951355,9.991978,5.92004776,56,60,0,0,0,64,113,1815,1663,1750,1170,0.9620001,0.85,0.91200006,74,38,47,100,1113.12048,25.0,1.51965976,37.0,31.7180557
14602,2022-03-21 17:46:04,60.0,100,100,100,100,100,100,0.992000043,1.0,3.3920002,3.3920002,0.992000043,0.984,1.008,3.3920002,3.26400018,0.496000022,0.6,0.528,0.992000043,1.008,1.016,26.0,27,26.0,15,23,25,1912.18127,2170.418,15.7986107,28.125,18.75,20.3125,20.5357132,24.36756,21.3149014,26,27,25,27,25,25,27,4005.52466,4005.52466,4005.52466,4005.52466,4005.52466,4005.52466,27.4211349,25.0393219,0,2.3485744,100.138115,62.9186249,10.0116272,5.90039825,57,60,0,0,0,64,113,1846,1630,1750,1194,0.775000036,0.85,0.91200006,78,43,48,100,1113.12048,25.0,1.51965976,37.0,31.7180557
14603,2022-03-21 17:46:05,60.0,100,100,100,100,100,100,0.904000044,1.008,3.37600017,3.3920002,0.992000043,0.984,1.008,3.37600017,3.26400018,0.496000022,0.6,0.528,0.992000043,1.008,1.016,26.0,27,26.0,15,23,25,1925.82031,2173.913,12.3076916,21.53846,7.69230747,22.3076935,12.3076916,9.230768,14.2307758,26,26,25,27,25,25,27,4005.525,4005.525,4005.525,4005.525,4005.525,4005.525,20.8719845,18.5765152,0,1.99586165,100.138123,62.9712677,10.0200043,5.892021,56,60,0,0,0,64,95,1878,1628,1750,1186,0.943,0.85,0.91200006,67,35,49,100,1113.12048,25.0,1.51965976,37.0,31.7180557
14604,2022-03-21 17:46:06,60.0,100,100,100,100,100,100,0.952,1.008,3.37600017,3.3920002,0.992000043,0.984,1.008,3.37600017,3.26400018,0.496000022,0.6,0.528,0.992000043,1.008,1.016,26.0,27,26.0,15,23,25,1923.0769,2170.418,7.69230747,28.46154,10.76923,16.1538486,16.1538486,12.3076916,15.2564049,25,33,24,26,27,26,33,4005.524,4005.524,4005.524,4005.524,4005.524,4005.524,22.5948944,20.2802429,0,2.125667,100.1381,63.00627,10.0255737,5.88645172,57,60,0,0,0,63,117,1898,1671,1750,1179,0.775000036,0.85,0.91200006,73,41,49,100,1113.12048,25.0,1.51965976,37.0,31.7180557
14605,2022-03-21 17:46:07,60.0,100,100,100,100,100,100,0.872000039,1.0,3.3920002,3.3920002,0.992000043,0.984,1.008,3.37600017,3.26400018,0.496000022,0.6,0.528,0.992000043,1.008,1.016,26.0,27,26.0,15,23,25,1936.87231,2166.934,10.15625,25.0,10.9375,17.96875,14.0625,7.03125,14.1927061,24,26,25,25,27,25,27,4005.52466,4005.52466,4005.52466,4005.52466,4005.52466,4005.52466,21.3769417,19.09552,0,2.0074873,100.138115,63.0828171,10.0377541,5.87427139,56,60,0,0,0,63,101,1917,1623,1750,1148,0.943,0.85,0.91200006,63,34,50,100,1113.12048,25.0,1.51965976,37.0,31.7180557
14606,2022-03-21 17:46:08,60.0,100,100,100,100,100,100,0.904000044,1.008,3.37600017,3.37600017,0.992000043,0.984,1.008,3.37600017,3.26400018,0.496000022,0.6,0.528,0.992000043,1.008,1.016,26.0,27,25.5,15,23,25,1934.09741,2166.934,13.28125,21.09375,17.96875,22.6810513,8.59375,14.0625,16.2801743,25,33,24,27,24,24,33,4005.52466,4005.52466,4005.52466,4005.52466,4005.52466,4005.52466,23.4479141,21.1116447,0,2.1715107,100.138115,63.16363,10.0506134,5.861412,57,60,0,0,0,63,112,1921,1622,1750,1118,0.775000036,0.85,0.91200006,69,38,50,100,1113.12048,25.0,1.51965976,37.0,31.7180557
14607,2022-03-21 17:46:09,60.0,100,100,100,100,100,100,0.856000066,1.0,3.3920002,3.3920002,0.992000043,0.984,1.008,3.37600017,3.26400018,0.496000022,0.6,0.528,0.992000043,1.008,1.008,26.0,27,26.0,15,23,25,1923.0769,2170.418,12.3076916,23.0769215,6.92307949,16.899765,13.0769253,11.5384579,13.9704762,24,26,23,26,24,24,26,4005.52441,4005.52441,4005.52441,4005.52441,4005.52441,4005.52441,20.89846,18.61939,0,1.98462975,100.138115,63.2006454,10.0565033,5.855522,57,62,0,0,0,64,105,1919,1600,1750,1123,0.9620001,0.85,0.91200006,66,35,50,100,1113.12048,25.0,1.51965976,37.0,31.7180557
14608,2022-03-21 17:46:10,60.0,100,100,100,100,100,100,0.880000055,1.0,3.3920002,3.37600017,0.992000043,0.984,1.008,3.37600017,3.26400018,0.496000022,0.6,0.528,0.992000043,1.008,1.016,26.0,27,26.0,15,23,25,1920.34143,2170.418,15.625,26.5625,17.1875,17.1875,14.0625,15.625,17.7083321,24,26,24,27,35,25,35,4005.524,4005.524,4005.524,4005.524,4005.524,4005.524,24.9071178,22.5522366,0,2.21006465,100.1381,64.00351,10.1842537,5.72777176,57,60,0,0,0,63,100,1919,1610,1750,1181,0.943,0.85,0.91200006,62,34,50,100,1113.12048,25.0,1.51965976,37.0,31.7180557
14609,2022-03-21 17:46:11,60.0,100,100,100,100,100,100,0.9760001,1.008,3.3920002,3.37600017,0.992000043,0.984,1.008,3.37600017,3.26400018,0.496000022,0.6,0.528,0.992000043,1.008,1.016,26.0,27,26.0,15,23,25,1912.18127,2170.418,14.0625,31.25,11.71875,18.75,15.625,17.1875,18.0989571,25,27,24,27,26,25,27,4005.52515,4005.52515,4005.52515,4005.52515,4005.52515,4005.52515,23.5925751,21.2689323,0,2.15614748,100.13813,63.7139,10.1381721,5.7738533,57,60,0,0,0,63,121,1921,1687,1750,1227,0.775000036,0.85,0.91200006,78,43,50,100,1113.12048,25.0,1.51965976,37.0,31.7180557
