,Unnamed: 0,Time,Fan Control #1,Fan Control #2,Fan Control #3,Fan Control #4,Fan Control #5,Fan Control #6,Fan Control #7,CPU VCore,Voltage #2,AVCC,3VCC,Voltage #5,Voltage #6,Voltage #7,3VSB,VBAT,VTT,Voltage #11,Voltage #12,Voltage #13,Voltage #14,Voltage #15,Temperature #1,Temperature #2,Temperature #3,Temperature #4,Temperature #5,Temperature #6,Fan #2,Fan #3,CPU Core #1,CPU Core #2,CPU Core #3,CPU Core #4,CPU Core #5,CPU Core #6,CPU Total,CPU Core #1.1,CPU Core #2.1,CPU Core #3.1,CPU Core #4.1,CPU Core #5.1,CPU Core #6.1,CPU Package,CPU Core #1.2,CPU Core #2.2,CPU Core #3.2,CPU Core #4.2,CPU Core #5.2,CPU Core #6.2,CPU Package.1,CPU Cores,CPU Graphics,CPU DRAM,Bus Speed,Memory,Used Memory,Available Memory,GPU Core,GPU Memory,GPU VRM Core,GPU VRM Memory #1,GPU VRM Memory #2,GPU Hot Spot,GPU Total,GPU Fan,GPU Core.1,GPU Memory.1,GPU SOC,GPU Core.2,GPU Memory.2,GPU SOC.1,GPU Core.3,GPU Memory.3,GPU Fan.1,Remaining Life,Total Bytes Written,Temperature,Write Amplification,Temperature.1,Used Space,Used Space.1
13211,13211,2022-03-21 17:22:41-04:00,60.0,100,100,100,100,100,100,0.944000065,1.008,3.3920002,3.40800023,0.992000043,0.9760001,1.016,3.3920002,3.26400018,0.504,0.6,0.528,0.992000043,1.008,1.016,27.0,27,25.5,15,23,25,1912.18127,2166.934,17.96875,21.875,13.28125,21.875,12.5,10.9375,16.40625,30,25,26,26,25,24,30,4005.52417,4005.52417,4005.52417,4005.52417,4005.52417,4005.52417,19.9620571,17.0506039,0,1.54671812,100.1381,55.07789,8.764008,7.148018,50,52,0,0,0,50,28,0,790,1750,254,0.775000036,0.85,0.8,17,2,0,100.0,1113.12048,25,1.51965642,37.0,31.7180481,
13212,13212,2022-03-21 17:22:42-04:00,60.0,100,100,100,100,100,100,0.984,1.008,3.3920002,3.40800023,0.992000043,0.9760001,1.016,3.3920002,3.26400018,0.496000022,0.6,0.528,0.992000043,1.008,1.016,27.0,27,25.5,15,23,25,1928.57141,2177.41943,10.9375,17.96875,13.28125,22.65625,13.28125,7.8125,14.3229189,24,25,24,31,24,24,31,4005.52441,4005.52441,4005.52441,4005.52441,4005.52441,4005.52441,18.8716679,15.980525,0,1.436464,100.138107,55.1263847,8.771725,7.14030075,49,52,0,0,0,50,27,0,789,1730,338,0.8,0.85,0.8,29,4,0,100.0,1113.12048,25,1.51965642,37.0,31.7180481,
13213,13213,2022-03-21 17:22:43-04:00,60.0,100,100,100,100,100,100,0.9760001,1.008,3.3920002,3.40800023,0.992000043,0.9760001,1.008,3.3920002,3.26400018,0.496000022,0.6,0.528,0.992000043,1.008,1.016,27.0,27,25.5,15,23,25,1925.82031,2173.913,15.625,14.84375,17.1875,17.1875,8.59375,9.375,13.8020811,26,26,26,28,25,25,28,4005.52441,4005.52441,4005.52441,4005.52441,4005.52441,4005.52441,18.7081814,15.8101044,0,1.418643,100.138115,55.10956,8.769047,7.14297867,50,52,0,0,0,50,28,0,790,1716,244,0.775000036,0.85,0.8,18,3,0,100.0,1113.12048,25,1.51965642,37.0,31.7180481,
13214,13214,2022-03-21 17:22:44-04:00,60.0,100,100,100,100,100,100,1.0,1.008,3.3920002,3.40800023,0.992000043,0.9760001,1.008,3.3920002,3.26400018,0.504,0.6,0.528,0.992000043,1.016,1.016,27.0,27,25.5,15,23,25,1936.87231,2173.913,14.84375,19.53125,11.71875,19.53125,10.15625,9.375,14.1927061,30,26,23,25,23,24,30,4005.52466,4005.52466,4005.52466,4005.52466,4005.52466,4005.52466,18.64451,15.7629328,0,1.42371285,100.138115,55.1156731,8.77002,7.142006,50,52,0,0,0,50,33,0,787,1750,448,0.8,0.85,0.8,41,5,0,100.0,1113.12048,25,1.51965642,37.0,31.7180481,
13215,13215,2022-03-21 17:22:45-04:00,60.0,100,100,100,100,100,100,0.952,1.008,3.3920002,3.40800023,0.992000043,0.9760001,1.008,3.3920002,3.26400018,0.496000022,0.6,0.528,0.992000043,1.016,1.016,27.0,27,25.5,15,23,25,1936.87231,2177.41943,11.71875,14.84375,11.71875,23.4375,13.28125,6.25,13.5416689,24,25,24,29,25,24,29,4005.52417,4005.52417,4005.52417,4005.52417,4005.52417,4005.52417,18.8874588,15.9476032,0,1.44378543,100.138107,55.1012154,8.767719,7.144306,50,54,0,0,0,50,33,0,788,1746,382,0.775000036,0.85,0.8,30,5,0,100.0,1113.12048,25,1.51965642,37.0,31.7180481,
13216,13216,2022-03-21 17:22:46-04:00,60.0,100,100,100,100,100,100,0.960000038,1.008,3.3920002,3.40800023,0.992000043,0.9760001,1.008,3.3920002,3.26400018,0.496000022,0.6,0.528,0.992000043,1.008,1.016,27.0,27,25.5,15,23,25,1923.0769,2173.913,17.6923027,19.23077,12.3076916,16.9230766,13.0769253,9.230768,14.7435961,28,27,25,26,28,25,28,4005.52417,4005.52417,4005.52417,4005.52417,4005.52417,4005.52417,19.5731277,16.6213779,0,1.476542,100.138107,55.117466,8.770306,7.14172,50,52,0,0,0,51,28,0,790,1750,286,0.775000036,0.85,0.8,22,3,0,100.0,1113.12048,25,1.51965642,37.0,31.7180481,
