,Time,Fan Control #1,Fan Control #2,Fan Control #3,Fan Control #4,Fan Control #5,Fan Control #6,Fan Control #7,CPU VCore,Voltage #2,AVCC,3VCC,Voltage #5,Voltage #6,Voltage #7,3VSB,VBAT,VTT,Voltage #11,Voltage #12,Voltage #13,Voltage #14,Voltage #15,Temperature #1,Temperature #2,Temperature #3,Temperature #4,Temperature #5,Temperature #6,Fan #2,Fan #3,CPU Core #1,CPU Core #2,CPU Core #3,CPU Core #4,CPU Core #5,CPU Core #6,CPU Total,CPU Core #1.1,CPU Core #2.1,CPU Core #3.1,CPU Core #4.1,CPU Core #5.1,CPU Core #6.1,CPU Package,CPU Core #1.2,CPU Core #2.2,CPU Core #3.2,CPU Core #4.2,CPU Core #5.2,CPU Core #6.2,CPU Package.1,CPU Cores,CPU Graphics,CPU DRAM,Bus Speed,Memory,Used Memory,Available Memory,GPU Core,GPU Core.1,GPU Memory,GPU Shader,GPU,GPU Core.2,GPU Frame Buffer,GPU Video Engine,GPU Bus Interface,GPU Fan,GPU Memory Total,GPU Memory Used,GPU Memory Free,GPU Memory.1,GPU Power,GPU PCIE Rx,GPU PCIE Tx,Remaining Life,Total Bytes Written,Used Space,Temperature,Write Amplification,Remaining Life.1,Total Bytes Written.1,Used Space.1,Temperature.1,Write Amplification.1
16172,2022-03-30 23:07:32,60.0,100,100,100,100,100,100,0.960000038,1.008,3.3920002,3.40800023,0.992000043,0.992000043,1.008,3.37600017,3.26400018,0.496000022,0.6,0.528,0.992000043,1.016,1.016,27.0,26,25.5,15,23,25,1934.09741,2177.41943,10.9375,14.0625,6.25,5.46875,16.40625,15.625,11.4583311,26,27,24,25,26,28,28,4005.51563,4005.51563,4005.51563,4005.51563,4005.51563,4005.51563,18.2773666,16.0723763,0,1.42615891,100.137886,39.1189041,6.22460938,9.687416,46,1126.0105,3505.50024,2252.021,1216,3,1,0,1,37,2048,1300.84375,747.15625,63.51776,28.4980011,174.804688,67.38281,99,2209.315,81.5070648,26,1.528207,100,1223.38745,46.5730247,26,1.55734241
16173,2022-03-30 23:07:33,60.0,100,100,100,100,100,100,0.9760001,1.008,3.3920002,3.40800023,0.992000043,0.992000043,1.008,3.3920002,3.26400018,0.496000022,0.6,0.528,0.992000043,1.008,1.016,27.0,26,25.5,15,23,25,1934.09741,2173.913,9.230768,19.23077,17.6923027,18.4615364,12.3076916,19.9999981,16.1538429,27,26,35,26,26,31,35,4005.51563,4005.51563,4005.51563,4005.51563,4005.51563,4005.51563,20.2289772,17.9950581,0,1.66519058,100.137894,39.23462,6.243023,9.669003,46,949.218567,3505.50024,1898.43713,1213,6,2,0,1,37,2048,1307.84375,740.15625,63.85956,27.2750015,179.6875,24.4140625,99,2209.315,81.5070648,26,1.528207,100,1223.38745,46.5730247,26,1.55734241
16174,2022-03-30 23:07:34,60.0,100,100,100,100,100,100,0.968000054,1.008,3.3920002,3.40800023,0.992000043,0.992000043,1.008,3.3920002,3.26400018,0.496000022,0.6,0.528,0.992000043,1.008,1.016,27.5,26,25.5,15,23,25,1934.09741,2184.466,6.92307949,16.9230766,9.230768,11.5384579,24.6153831,13.8461533,13.8461533,25,25,25,25,32,25,32,4005.51563,4005.51563,4005.51563,4005.51563,4005.51563,4005.51563,17.9256725,15.6922,0,1.5337224,100.137886,39.2660751,6.248028,9.663998,45,949.218567,3505.50024,1898.43713,1211,4,2,0,1,37,2048,1299.34375,748.65625,63.44452,27.2890015,177.734375,109.375,99,2209.315,81.5070648,26,1.528207,100,1223.38745,46.5730247,26,1.55734241
16175,2022-03-30 23:07:35,60.0,100,100,100,100,100,100,0.952,1.008,3.3920002,3.40800023,0.992000043,0.992000043,1.008,3.3920002,3.26400018,0.496000022,0.6,0.528,0.992000043,1.008,1.016,27.0,26,25.5,15,23,25,1920.34143,2177.41943,9.230768,22.3076935,10.76923,14.6153812,20.7692261,6.92307949,14.10256,27,27,25,37,25,30,37,4005.51514,4005.51514,4005.51514,4005.51514,4005.51514,4005.51514,19.3530712,17.1235142,0,1.62222958,100.137878,39.3113365,6.25523,9.6567955,45,949.218567,3505.50024,1898.43713,1209,6,2,0,1,37,2048,1307.84375,740.15625,63.85956,27.179,709.960938,117.1875,99,2209.315,81.5070648,26,1.528207,100,1223.38745,46.5730247,26,1.55734241
16176,2022-03-30 23:07:36,60.0,100,100,100,100,100,100,0.952,1.008,3.3920002,3.40800023,0.992000043,0.992000043,1.008,3.37600017,3.26400018,0.504,0.6,0.528,0.992000043,1.008,1.016,27.0,26,25.5,15,23,25,1920.34143,2180.937,7.8125,17.96875,6.25,16.40625,14.84375,17.96875,13.5416689,25,31,24,25,25,24,31,4005.51563,4005.51563,4005.51563,4005.51563,4005.51563,4005.51563,18.5439224,16.33427,0,1.53390229,100.137894,39.3791847,6.26602554,9.646,45,911.250061,3004.6792,1822.50012,1208,8,2,0,1,37,2048,1308.875,739.125,63.9099121,27.2790012,177.734375,66.40625,99,2209.315,81.5070648,26,1.528207,100,1223.38745,46.5730247,26,1.55734241
16177,2022-03-30 23:07:37,60.0,100,100,100,100,100,100,0.9760001,1.008,3.3920002,3.40800023,0.992000043,0.992000043,1.008,3.37600017,3.26400018,0.496000022,0.6,0.528,0.992000043,1.008,1.016,27.0,26,25.5,15,23,25,1920.34143,2177.41943,18.4615364,23.0769215,9.230768,8.4615345,13.0769253,19.23077,15.2564049,37,26,25,26,25,30,37,4005.51563,4005.51563,4005.51563,4005.51563,4005.51563,4005.51563,21.2960968,19.0274448,0,1.7268759,100.137886,39.4500961,6.27730942,9.634716,45,911.250061,3004.6792,1822.50012,1207,11,3,0,1,37,2048,1317.375,730.625,64.32495,26.992,176.757813,67.38281,99,2209.315,81.5070648,26,1.528207,100,1223.38745,46.5730247,26,1.55734241
16178,2022-03-30 23:07:38,60.0,100,100,100,100,100,100,0.9760001,1.008,3.3920002,3.40800023,0.992000043,0.992000043,1.008,3.3920002,3.26400018,0.496000022,0.6,0.528,0.992000043,1.016,1.016,27.0,26,25.5,15,23,25,1917.61365,2173.913,17.1875,21.875,14.84375,13.3556547,19.70486,15.625,17.0986233,25,25,25,25,33,25,33,4005.51514,4005.51514,4005.51514,4005.51514,4005.51514,4005.51514,20.6369762,17.2788677,0,1.5669893,100.137878,39.6678047,6.31195068,9.600075,45,708.750061,810.000061,1417.50012,1207,16,11,0,3,36,2048,1318.9375,729.0625,64.4012451,16.3130016,2.9296875,109.375,99,2209.315,81.5070648,26,1.528207,100,1223.38745,46.5730247,26,1.55734241
