,Time,Fan Control #1,Fan Control #2,Fan Control #3,Fan Control #4,Fan Control #5,Fan Control #6,Fan Control #7,CPU VCore,Voltage #2,AVCC,3VCC,Voltage #5,Voltage #6,Voltage #7,3VSB,VBAT,VTT,Voltage #11,Voltage #12,Voltage #13,Voltage #14,Voltage #15,Temperature #1,Temperature #2,Temperature #3,Temperature #4,Temperature #5,Temperature #6,Fan #2,Fan #3,CPU Core #1,CPU Core #2,CPU Core #3,CPU Core #4,CPU Core #5,CPU Core #6,CPU Total,CPU Core #1.1,CPU Core #2.1,CPU Core #3.1,CPU Core #4.1,CPU Core #5.1,CPU Core #6.1,CPU Package,CPU Core #1.2,CPU Core #2.2,CPU Core #3.2,CPU Core #4.2,CPU Core #5.2,CPU Core #6.2,CPU Package.1,CPU Cores,CPU Graphics,CPU DRAM,Bus Speed,Memory,Used Memory,Available Memory,GPU Core,GPU Core.1,GPU Memory,GPU Shader,GPU,GPU Core.2,GPU Frame Buffer,GPU Video Engine,GPU Bus Interface,GPU Fan,GPU Memory Total,GPU Memory Used,GPU Memory Free,GPU Memory.1,GPU Power,GPU PCIE Rx,GPU PCIE Tx,Remaining Life,Total Bytes Written,Used Space,Temperature,Write Amplification,Remaining Life.1,Total Bytes Written.1,Used Space.1,Temperature.1,Write Amplification.1
16640,2022-03-30 23:15:26,60.0,100,100,100,100,100,100,0.9760001,1.008,3.3920002,3.40800023,0.992000043,0.9760001,1.008,3.3920002,3.26400018,0.496000022,0.6,0.528,0.992000043,1.016,1.016,27.0,27,25.5,15,23,25,1923.0769,2180.937,3.8461566,16.9230766,10.76923,11.5384579,23.84615,10.0000019,12.8205118,28,25,33,26,29,26,33,4005.515,4005.515,4005.515,4005.515,4005.515,4005.515,18.5476055,16.3501225,0,1.43682706,100.137871,42.5815125,6.77558136,9.136444,43,1126.0105,3505.50024,2252.021,1127,3,1,0,1,34,2048,1287.90625,760.09375,62.8860474,28.1150017,172.851563,24.4140625,99,2209.76929,81.49886,26,1.52833652,100,1223.38843,46.5730247,26,1.55734241
16641,2022-03-30 23:15:27,60.0,100,100,100,100,100,100,0.968000054,1.008,3.3920002,3.40800023,0.992000043,0.9760001,1.008,3.3920002,3.26400018,0.496000022,0.6,0.528,0.992000043,1.008,1.016,27.0,27,25.5,15,23,25,1931.33044,2180.937,14.0625,14.0625,14.84375,16.40625,25.78125,9.375,15.7552061,27,26,26,27,30,26,30,4005.516,4005.516,4005.516,4005.516,4005.516,4005.516,19.5034561,17.2909088,0,1.55108654,100.1379,42.557827,6.77181244,9.140213,43,911.250061,3004.6792,1822.50012,1128,5,2,0,1,34,2048,1296.40625,751.59375,63.3010864,26.141,180.664063,66.40625,99,2209.76929,81.49886,26,1.52833652,100,1223.38843,46.5730247,26,1.55734241
16642,2022-03-30 23:15:28,60.0,100,100,100,100,100,100,0.952,1.008,3.3920002,3.40800023,0.992000043,0.9760001,1.008,3.3920002,3.26400018,0.504,0.6,0.528,0.992000043,1.016,1.016,27.0,27,25.5,15,23,25,1931.33044,2180.937,17.6923027,15.3846149,13.8461533,7.69230747,16.9230766,12.3076916,13.9743567,26,31,26,27,28,26,31,4005.51538,4005.51538,4005.51538,4005.51538,4005.51538,4005.51538,19.0142136,16.7757168,0,1.56173575,100.137878,42.6646767,6.78881454,9.123211,42,911.250061,3004.6792,1822.50012,1126,4,2,0,1,34,2048,1286.40625,761.59375,62.8128052,26.0430012,184.570313,67.38281,99,2209.76929,81.49886,26,1.52833652,100,1223.38843,46.5730247,26,1.55734241
16643,2022-03-30 23:15:29,60.0,100,100,100,100,100,100,0.960000038,1.008,3.3920002,3.40800023,0.992000043,0.9760001,1.008,3.3920002,3.26400018,0.496000022,0.6,0.528,0.992000043,1.016,1.016,27.0,27,25.5,15,23,25,1920.34143,2180.937,9.375,21.875,11.71875,9.375,22.65625,24.21875,16.5364571,26,26,26,27,32,26,32,4005.51563,4005.51563,4005.51563,4005.51563,4005.51563,4005.51563,19.9477825,17.7100716,0,1.65969384,100.137894,42.6594276,6.787979,9.124046,42,911.250061,3004.6792,1822.50012,1124,5,2,0,1,34,2048,1294.90625,753.09375,63.2278442,26.0430012,176.757813,67.38281,99,2209.76929,81.49886,26,1.52833652,100,1223.38843,46.5730247,26,1.55734241
16644,2022-03-30 23:15:30,60.0,100,100,100,100,100,100,0.968000054,1.008,3.3920002,3.42400026,0.992000043,0.9760001,1.008,3.3920002,3.26400018,0.504,0.6,0.528,0.992000043,1.016,1.016,27.0,27,25.5,15,23,25,1912.18127,2180.937,11.5384579,19.23077,16.1538486,11.5384579,26.1538448,18.4615364,17.1794834,24,31,24,25,25,25,31,4005.51538,4005.51538,4005.51538,4005.51538,4005.51538,4005.51538,21.9172382,16.9342041,0,1.56716084,100.137886,42.7667351,6.80505371,9.106972,41,772.031067,810.000061,1544.06213,1124,11,6,0,3,34,2048,1290.77734,757.222656,63.0262375,15.6430006,173.828125,67.38281,99,2209.78223,81.5020752,26,1.5283345,100,1223.38843,46.5730247,26,1.55734241
16645,2022-03-30 23:15:31,60.0,100,100,100,100,100,100,0.9760001,1.008,3.37600017,3.40800023,0.992000043,0.9760001,1.008,3.37600017,3.26400018,0.504,0.6,0.528,0.992000043,1.016,1.016,27.0,27,25.5,15,23,25,1909.47668,2180.937,7.03125,11.71875,10.9375,7.8125,36.71875,10.9375,14.1927061,31,28,31,27,31,26,31,4005.51514,4005.51514,4005.51514,4005.51514,4005.51514,4005.51514,24.5277977,17.9254837,0,1.66799855,100.137878,42.9125443,6.8282547,9.083771,41,772.031067,810.000061,1544.06213,1125,16,10,0,3,34,2048,1304.4375,743.5625,63.6932373,16.7860012,173.828125,109.375,99,2209.78223,81.5020752,26,1.5283345,100,1223.38843,46.5730247,26,1.55734241
16646,2022-03-30 23:15:32,60.0,100,100,100,100,100,100,0.952,1.008,3.3920002,3.42400026,0.992000043,0.9760001,1.008,3.3920002,3.26400018,0.496000022,0.6,0.528,0.992000043,1.016,1.016,27.0,27,25.5,15,23,25,1912.18127,2180.937,10.9375,17.1875,7.8125,15.625,22.65625,17.96875,15.3645811,25,25,25,32,27,27,32,4005.51563,4005.51563,4005.51563,4005.51563,4005.51563,4005.51563,23.3843632,16.8012772,0,1.54518235,100.137886,43.10431,6.85876846,9.053257,41,772.031067,810.000061,1544.06213,1123,14,9,0,3,34,2048,1304.4375,743.5625,63.6932373,16.1230011,170.898438,67.38281,99,2209.78223,81.5020752,26,1.5283345,100,1223.38843,46.5730247,26,1.55734241
