,Unnamed: 0,Time,Fan Control #1,Fan Control #2,Fan Control #3,Fan Control #4,Fan Control #5,Fan Control #6,CPU VCore,Voltage #2,AVCC,3VCC,Voltage #5,Voltage #6,Voltage #7,3VSB,VBAT,VTT,Voltage #11,Voltage #12,Voltage #13,Voltage #14,Voltage #15,CPU Core,Temperature #1,Temperature #2,Temperature #3,Temperature #4,Temperature #5,Temperature #6,Fan #1,Fan #2,CPU Core #1,CPU Core #2,CPU Core #3,CPU Core #4,CPU Total,CPU Core #1.1,CPU Core #2.1,CPU Core #3.1,CPU Core #4.1,CPU Package,CPU Core #1.2,CPU Core #2.2,CPU Core #3.2,CPU Core #4.2,CPU Package.1,CPU Cores,CPU Graphics,CPU DRAM,Bus Speed,Memory,Used Memory,Available Memory,GPU Core,GPU Memory,GPU VRM Core,GPU VRM Memory #1,GPU VRM Memory #2,GPU Hot Spot,GPU Total,GPU Fan,GPU Core.1,GPU Memory.1,GPU SOC,GPU Core.2,GPU Memory.2,GPU SOC.1,GPU Core.3,GPU Memory.3,GPU Fan.1,Remaining Life,Total Bytes Written,Used Space,Temperature,Write Amplification,Remaining Life.1,Total Bytes Written.1,Used Space.1,Temperature.1,Write Amplification.1
12674,12674,2022-03-31 14:41:04-04:00,82.35294,100,49.80392,49.80392,49.80392,49.80392,0.56,1.016,3.42400026,3.42400026,1.0,0.160000011,0.944000065,3.40800023,3.2,0.984,0.15200001,0.128,0.144000009,0.128,0.136,38,30.0,117,29.0,110,109,108,1695.97986,2188.00659,76.5625,76.5625,76.5625,70.3125,75.0,33,32,36,34,36,3904.46118,3904.46118,4004.57544,3904.46118,31.24747,26.513588,0,2.427068,100.114388,38.77175,6.179905,9.759289,52,56,0,0,0,52,10,1750,789,202,62,0.775000036,0.675,0.8,0,1,46,100,1495.82556,46.5730247,26,1.5312233,99,2305.25684,84.7723541,27,1.53632581
12675,12675,2022-03-31 14:41:05-04:00,82.35294,100,49.80392,49.80392,49.80392,49.80392,0.56,1.008,3.42400026,3.3920002,1.0,0.160000011,0.944000065,3.40800023,3.2,0.984,0.15200001,0.128,0.144000009,0.128,0.136,42,30.0,117,29.0,110,109,108,1685.39331,2184.466,90.625,82.8125,85.9375,87.5,86.71875,40,42,41,41,42,3904.461,3904.461,3904.461,3904.461,37.61098,33.0288734,0,3.16884685,100.114388,38.9652748,6.21075058,9.728443,56,58,0,0,0,59,63,1728,1461,1750,1230,0.843000054,0.85,0.91200006,77,25,45,100,1495.82556,46.5730247,26,1.5312233,99,2305.25684,84.7723541,27,1.53632581
12676,12676,2022-03-31 14:41:06-04:00,82.7451,100,49.80392,49.80392,49.80392,49.80392,0.56,1.008,3.40800023,3.3920002,1.0,0.160000011,0.944000065,3.40800023,3.2,0.984,0.15200001,0.128,0.144000009,0.128,0.136,42,30.0,117,29.0,110,109,108,1685.39331,2188.00659,98.4375,93.75,90.625,98.4375,95.3125,41,42,40,42,42,3904.46045,3904.46045,3904.46045,3904.46045,38.5429153,33.9652443,0,3.226676,100.114372,38.9716377,6.21176529,9.727428,56,58,0,0,0,59,72,1705,1599,1750,1189,0.9620001,0.85,0.91200006,67,21,44,100,1495.82556,46.5730247,26,1.5312233,99,2305.25684,84.7723541,27,1.53632581
12677,12677,2022-03-31 14:41:07-04:00,82.7451,100,49.80392,49.80392,49.80392,49.80392,0.56,1.008,3.42400026,3.3920002,1.0,0.160000011,0.944000065,3.40800023,3.2,0.984,0.15200001,0.128,0.144000009,0.128,0.136,41,30.0,117,29.0,110,109,108,1674.938,2188.00659,95.3125,95.3125,90.625,85.9375,91.796875,41,42,39,41,42,3904.461,3904.461,3904.461,3904.461,36.64905,32.0982666,0,2.9786098,100.114388,39.15791,6.241455,9.697739,56,60,0,0,0,62,94,1673,1704,1750,1235,0.9620001,0.85,0.91200006,74,26,44,100,1495.82556,46.5730247,26,1.5312233,99,2305.25684,84.7723541,27,1.53632581
12678,12678,2022-03-31 14:41:08-04:00,82.7451,100,49.80392,49.80392,49.80392,49.80392,0.56,1.008,3.40800023,3.3920002,1.0,0.160000011,0.944000065,3.40800023,3.2,0.984,0.15200001,0.128,0.144000009,0.128,0.136,42,30.0,117,29.0,110,109,108,1685.39331,2188.00659,95.3125,98.4375,93.75,95.3125,95.703125,41,42,40,42,42,3904.46118,3904.46118,3904.46118,3904.46118,38.18426,33.5972672,0,3.13945675,100.114388,39.4345741,6.285553,9.653641,57,60,0,0,0,61,78,1661,1490,1750,1153,0.9620001,0.85,0.91200006,79,26,43,100,1495.82556,46.5730247,26,1.5312233,99,2305.25684,84.7723541,27,1.53632581
12679,12679,2022-03-31 14:41:09-04:00,82.7451,100,49.80392,49.80392,49.80392,49.80392,0.56,1.008,3.42400026,3.3920002,1.0,0.160000011,0.944000065,3.40800023,3.2,0.984,0.15200001,0.128,0.144000009,0.128,0.136,42,30.0,117,29.0,110,109,108,1693.85193,2188.00659,95.3125,89.0625,82.8125,93.75,90.234375,41,42,40,43,43,3904.46045,3904.46045,3904.46045,3904.46045,37.942997,33.3832474,0,3.17837715,100.114372,39.5910225,6.31048965,9.628704,57,58,0,0,0,62,84,1658,1617,1750,1211,0.9620001,0.85,0.91200006,79,25,43,100,1495.82556,46.5730247,26,1.5312233,99,2305.25684,84.7723541,27,1.53632581
