,Time,Fan Control #1,Fan Control #2,Fan Control #3,Fan Control #4,Fan Control #5,Fan Control #6,Fan Control #7,CPU VCore,Voltage #2,AVCC,3VCC,Voltage #5,Voltage #6,Voltage #7,3VSB,VBAT,VTT,Voltage #11,Voltage #12,Voltage #13,Voltage #14,Voltage #15,Temperature #1,Temperature #2,Temperature #3,Temperature #4,Temperature #5,Temperature #6,Fan #2,Fan #3,CPU Core #1,CPU Core #2,CPU Core #3,CPU Core #4,CPU Core #5,CPU Core #6,CPU Total,CPU Core #1.1,CPU Core #2.1,CPU Core #3.1,CPU Core #4.1,CPU Core #5.1,CPU Core #6.1,CPU Package,CPU Core #1.2,CPU Core #2.2,CPU Core #3.2,CPU Core #4.2,CPU Core #5.2,CPU Core #6.2,CPU Package.1,CPU Cores,CPU Graphics,CPU DRAM,Bus Speed,Memory,Used Memory,Available Memory,Remaining Life,Total Bytes Written,Used Space,Temperature,Write Amplification,Remaining Life.1,Total Bytes Written.1,Used Space.1,Temperature.1,Write Amplification.1
12222,2022-03-30 22:24:54,60.0,100,100,60,60,100,100,0.9760001,1.008,3.3920002,3.42400026,1.0,1.008,1.016,3.3920002,3.26400018,0.496000022,0.6,0.528,0.992000043,1.016,1.016,26.0,26,25.5,15,23,25,1923.0769,2180.937,10.9375,10.15625,8.59375,10.9375,26.5625,14.0625,13.5416689,26,30,25,26,27,25,30,4005.51758,4005.51758,4005.51758,4005.51758,4005.51758,4005.51758,18.4280758,16.670784,0.864002,1.77584136,100.137939,49.6614342,7.867222,7.974491,99,2207.49463,81.4994659,25,1.52786207,100,1223.38513,46.5730247,26,1.557341
12223,2022-03-30 22:24:55,60.0,100,100,60,60,100,100,1.0,1.008,3.3920002,3.42400026,1.0,1.008,1.008,3.3920002,3.26400018,0.496000022,0.6,0.528,0.992000043,1.016,1.016,26.0,26,25.5,15,23,25,1914.89368,2184.466,12.5,21.875,15.625,17.96875,14.84375,16.40625,16.5364571,27,25,25,26,31,25,31,4005.517,4005.517,4005.517,4005.517,4005.517,4005.517,20.5805435,18.7992134,0.8490058,1.93337655,100.137924,49.7760048,7.885372,7.956341,99,2207.49463,81.4994659,25,1.52786207,100,1223.38513,46.5730247,26,1.557341
12224,2022-03-30 22:24:56,60.0,100,100,60,60,100,100,0.9760001,1.008,3.3920002,3.42400026,1.0,1.008,1.008,3.3920002,3.26400018,0.496000022,0.6,0.528,0.992000043,1.016,1.016,26.0,25,25.5,15,23,25,1917.61365,2180.937,14.84375,14.0625,17.1875,11.71875,23.4375,11.71875,15.4947939,27,25,26,25,30,25,30,4005.51758,4005.51758,4005.51758,4005.51758,4005.51758,4005.51758,20.1796627,18.3739872,0.8504491,1.9439888,100.137939,49.930748,7.90988541,7.93182755,99,2207.49463,81.4994659,25,1.52786207,100,1223.38513,46.5730247,26,1.557341
12225,2022-03-30 22:24:57,60.0,100,100,60,60,100,100,1.0,1.008,3.3920002,3.42400026,1.0,1.008,1.008,3.3920002,3.26400018,0.496000022,0.6,0.528,0.992000043,1.016,1.016,26.0,26,25.5,15,23,25,1925.82031,2184.466,15.625,14.84375,18.75,13.28125,19.53125,19.53125,16.9270821,31,26,25,26,28,25,31,4005.51782,4005.51782,4005.51782,4005.51782,4005.51782,4005.51782,20.75249,18.9384556,0.850292563,1.99791336,100.137947,49.86727,7.89983,7.941883,99,2207.49463,81.4994659,25,1.52786207,100,1223.38513,46.5730247,26,1.557341
12226,2022-03-30 22:24:58,60.0,100,100,60,60,100,100,0.984,1.008,3.3920002,3.42400026,1.0,1.008,1.016,3.3920002,3.26400018,0.504,0.6,0.528,0.992000043,1.016,1.016,26.0,26,25.5,15,23,25,1936.87231,2188.00659,11.71875,21.875,13.28125,9.375,21.09375,10.15625,14.5833311,26,28,25,27,26,24,28,4005.5166,4005.5166,4005.5166,4005.5166,4005.5166,4005.5166,19.4758625,17.5217037,1.002725,1.930377,100.137917,49.8702354,7.900299,7.941414,99,2207.49463,81.4994659,25,1.52786207,100,1223.38513,46.5730247,26,1.557341
12227,2022-03-30 22:24:59,60.0,100,100,60,60,100,100,1.0,1.008,3.3920002,3.40800023,1.0,1.008,1.008,3.3920002,3.26400018,0.496000022,0.6,0.528,0.992000043,1.016,1.016,26.0,25,25.5,15,23,25,1923.0769,2184.466,14.0625,17.96875,14.0625,15.625,29.6875,11.71875,17.1875,29,26,32,27,28,26,32,4005.518,4005.518,4005.518,4005.518,4005.518,4005.518,24.7302265,19.7094135,4.0394783,2.11373377,100.137955,49.946228,7.91233826,7.92937469,99,2207.49463,81.4994659,25,1.52786207,100,1223.38513,46.5730247,26,1.557341
12228,2022-03-30 22:25:00,60.0,100,100,60,60,100,100,0.968000054,1.008,3.3920002,3.42400026,1.0,1.008,1.008,3.3920002,3.26400018,0.496000022,0.6,0.528,0.992000043,1.016,1.016,26.0,26,25.5,15,23,25,1914.89368,2184.466,17.3239117,18.067955,12.5,7.862103,23.6235142,13.28125,15.4431162,24,25,24,25,31,25,31,4005.51685,4005.51685,4005.51685,4005.51685,4005.51685,4005.51685,23.1360264,17.70344,4.482354,1.97537982,100.137924,50.0513878,7.928997,7.912716,99,2207.49463,81.4994659,25,1.52786207,100,1223.38513,46.5730247,26,1.557341
12229,2022-03-30 22:25:01,60.0,100,100,60,60,100,100,0.9760001,1.008,3.3920002,3.42400026,1.0,1.008,1.016,3.3920002,3.26400018,0.496000022,0.6,0.528,0.992000043,1.008,1.016,26.0,26,25.5,15,23,25,1925.82031,2184.466,14.7836571,17.0913467,12.5,12.6251516,24.0384579,15.6994047,16.123003,26,25,25,25,25,30,30,4005.51758,4005.51758,4005.51758,4005.51758,4005.51758,4005.51758,22.7861958,17.29368,4.54826164,1.97596276,100.137939,50.0721664,7.932289,7.909424,99,2207.49463,81.4994659,25,1.52786207,100,1223.38513,46.5730247,26,1.557341
