,Time,Fan Control #1,Fan Control #2,Fan Control #3,Fan Control #4,Fan Control #5,Fan Control #6,Fan Control #7,CPU VCore,Voltage #2,AVCC,3VCC,Voltage #5,Voltage #6,Voltage #7,3VSB,VBAT,VTT,Voltage #11,Voltage #12,Voltage #13,Voltage #14,Voltage #15,Temperature #1,Temperature #2,Temperature #3,Temperature #4,Temperature #5,Temperature #6,Fan #2,Fan #3,CPU Core #1,CPU Core #2,CPU Core #3,CPU Core #4,CPU Core #5,CPU Core #6,CPU Total,CPU Core #1.1,CPU Core #2.1,CPU Core #3.1,CPU Core #4.1,CPU Core #5.1,CPU Core #6.1,CPU Package,CPU Core #1.2,CPU Core #2.2,CPU Core #3.2,CPU Core #4.2,CPU Core #5.2,CPU Core #6.2,CPU Package.1,CPU Cores,CPU Graphics,CPU DRAM,Bus Speed,Memory,Used Memory,Available Memory,Remaining Life,Total Bytes Written,Used Space,Temperature,Write Amplification,Remaining Life.1,Total Bytes Written.1,Used Space.1,Temperature.1,Write Amplification.1
11951,2022-03-30 22:20:21,60.0,100,100,60,60,100,100,0.960000038,1.008,3.3920002,3.42400026,1.0,1.008,1.008,3.3920002,3.26400018,0.496000022,0.6,0.528,0.992000043,1.016,1.016,26.0,25,25.5,15,23,25,1925.82031,2191.55835,8.618551,7.8125,11.71875,12.5,21.875,16.40625,13.1551743,25,25,24,25,30,25,30,4005.51782,4005.51782,4005.51782,4005.51782,4005.51782,4005.51782,17.5159378,15.8076649,0.8299874,1.71041226,100.137947,48.262455,7.64559937,8.196114,99,2207.38525,81.49953,25,1.52787375,100,1223.38489,46.5730247,26,1.557341
11952,2022-03-30 22:20:22,60.0,100,100,60,60,100,100,0.952,1.008,3.3920002,3.42400026,1.0,1.008,1.016,3.3920002,3.26400018,0.504,0.6,0.528,0.992000043,1.008,1.016,26.0,25,25.5,15,23,25,1936.87231,2180.937,15.5048075,16.40625,12.5,17.1875,28.125,15.625,17.5580978,25,25,24,24,31,24,31,4005.517,4005.517,4005.517,4005.517,4005.517,4005.517,20.8815823,19.1042843,0.8334071,1.92653644,100.137924,48.03581,7.60969543,8.23201752,99,2207.38525,81.49953,25,1.52787375,100,1223.38489,46.5730247,26,1.557341
11953,2022-03-30 22:20:23,60.0,100,100,60,60,100,100,0.968000054,1.008,3.3920002,3.42400026,1.0,1.008,1.016,3.37600017,3.26400018,0.496000022,0.6,0.528,0.992000043,1.016,1.016,26.0,25,25.5,15,23,25,1923.0769,2184.466,10.9375,15.625,15.625,10.15625,29.6875,14.84375,16.1458321,32,33,25,25,24,25,33,4005.517,4005.517,4005.517,4005.517,4005.517,4005.517,19.82728,18.0470161,0.8342615,1.92355537,100.137924,48.7140045,7.71713257,8.12458,99,2207.38525,81.49953,25,1.52787375,100,1223.38489,46.5730247,26,1.557341
11954,2022-03-30 22:20:24,60.0,100,100,60,60,100,100,0.960000038,1.008,3.3920002,3.42400026,1.0,1.008,1.008,3.3920002,3.26400018,0.504,0.6,0.528,0.992000043,1.016,1.016,26.0,25,25.5,15,23,25,1923.0769,2184.466,10.15625,17.1875,13.28125,8.59375,25.0,14.0625,14.7135439,25,28,25,25,27,24,28,4005.51758,4005.51758,4005.51758,4005.51758,4005.51758,4005.51758,19.0141048,17.26561,0.822460949,1.85863173,100.137939,48.0930023,7.61875534,8.222958,99,2207.38525,81.49953,25,1.52787375,100,1223.38489,46.5730247,26,1.557341
11955,2022-03-30 22:20:25,60.0,100,100,60,60,100,100,0.968000054,1.008,3.3920002,3.42400026,1.0,1.008,1.008,3.3920002,3.26400018,0.496000022,0.6,0.528,0.992000043,1.016,1.016,26.0,25,25.5,15,23,25,1912.18127,2180.937,9.375,15.625,7.8125,8.59375,25.0,9.375,12.6302061,26,26,24,25,30,24,30,4005.51758,4005.51758,4005.51758,4005.51758,4005.51758,4005.51758,19.6337242,17.625967,1.06506228,1.92738819,100.137939,48.19192,7.634426,8.207287,99,2207.38525,81.49953,25,1.52787375,100,1223.38489,46.5730247,26,1.557341
11956,2022-03-30 22:20:26,60.0,100,100,60,60,100,100,0.968000054,1.008,3.3920002,3.42400026,1.0,1.008,1.016,3.3920002,3.26400018,0.504,0.6,0.528,0.992000043,1.008,1.016,26.0,25,25.5,15,23,25,1925.82031,2184.466,11.71875,14.84375,15.625,12.5,29.6875,14.0625,16.40625,26,25,24,24,31,26,31,4005.517,4005.517,4005.517,4005.517,4005.517,4005.517,21.2574177,17.0573921,3.274116,1.95435619,100.137924,48.1142654,7.62212372,8.219589,99,2207.38525,81.49953,25,1.52787375,100,1223.38489,46.5730247,26,1.557341
11957,2022-03-30 22:20:27,60.0,100,100,60,60,100,100,0.952,1.008,3.3920002,3.42400026,1.0,1.008,1.016,3.3920002,3.26400018,0.496000022,0.6,0.528,0.992000043,1.016,1.016,26.0,25,25.5,15,23,25,1925.82031,2184.466,11.71875,8.59375,10.9375,7.8125,28.4226189,22.65625,15.0235653,29,25,24,24,33,25,33,4005.51636,4005.51636,4005.51636,4005.51636,4005.51636,4005.51636,21.4222012,17.2130451,3.28788066,1.91717112,100.137909,48.2729263,7.64725876,8.194454,99,2207.38525,81.49953,25,1.52787375,100,1223.38489,46.5730247,26,1.557341
