,Unnamed: 0,Time,Fan Control #1,Fan Control #2,Fan Control #3,Fan Control #4,Fan Control #5,Fan Control #6,Fan Control #7,CPU VCore,Voltage #2,AVCC,3VCC,Voltage #5,Voltage #6,Voltage #7,3VSB,VBAT,VTT,Voltage #11,Voltage #12,Voltage #13,Voltage #14,Voltage #15,Temperature #1,Temperature #2,Temperature #3,Temperature #4,Temperature #5,Temperature #6,Fan #2,Fan #3,CPU Core #1,CPU Core #2,CPU Core #3,CPU Core #4,CPU Core #5,CPU Core #6,CPU Total,CPU Core #1.1,CPU Core #2.1,CPU Core #3.1,CPU Core #4.1,CPU Core #5.1,CPU Core #6.1,CPU Package,CPU Core #1.2,CPU Core #2.2,CPU Core #3.2,CPU Core #4.2,CPU Core #5.2,CPU Core #6.2,CPU Package.1,CPU Cores,CPU Graphics,CPU DRAM,Bus Speed,Memory,Used Memory,Available Memory,Remaining Life,Total Bytes Written,Used Space,Temperature,Write Amplification,Remaining Life.1,Total Bytes Written.1,Used Space.1,Temperature.1,Write Amplification.1
12003,12003,2022-03-30 22:21:13-04:00,60.0,100,100,60,60,100,100,0.960000038,1.008,3.3920002,3.42400026,1.0,1.008,1.016,3.3920002,3.26400018,0.496000022,0.6,0.528,0.992000043,1.016,1.016,26.0,25,25.5,15,23,25,1923.0769,2184.466,12.5,25.78125,10.9375,16.1458378,17.1875,16.40625,16.4930515,25,28,24,25,25,24,28,4005.517,4005.517,4005.517,4005.517,4005.517,4005.517,26.9317722,18.0198383,7.76019049,2.62926745,100.137932,53.7740974,8.518738,7.322975,99,2207.40063,81.5004,25,1.52787137,100,1223.38489,46.5730247,26,1.557341
12004,12004,2022-03-30 22:21:14-04:00,60.0,100,100,60,60,100,100,0.960000038,1.008,3.3920002,3.40800023,1.0,1.008,1.008,3.3920002,3.26400018,0.504,0.6,0.528,0.992000043,1.008,1.016,26.0,25,25.5,15,23,25,1934.09741,2180.937,18.75,20.3125,15.625,14.84375,10.9375,31.25,18.6197929,27,26,30,35,27,27,35,4005.51758,4005.51758,4005.51758,4005.51758,4005.51758,4005.51758,32.9725227,23.324152,8.264967,3.20402074,100.137939,55.2343369,8.750065,7.091648,99,2207.40063,81.5004,25,1.52787137,100,1223.38489,46.5730247,26,1.557341
12005,12005,2022-03-30 22:21:15-04:00,60.0,100,100,60,60,100,100,0.9760001,1.008,3.3920002,3.40800023,1.0,1.008,1.008,3.3920002,3.26400018,0.504,0.6,0.528,0.992000043,1.016,1.016,26.0,25,25.5,15,23,25,1934.09741,2184.466,25.0,25.0,24.21875,25.0,26.5625,14.9305582,23.4519653,35,27,26,27,27,27,35,4005.517,4005.517,4005.517,4005.517,4005.517,4005.517,32.9761276,21.2132721,10.5634451,2.92618418,100.137924,55.7317352,8.828861,7.01285172,99,2207.40063,81.5004,25,1.52787137,100,1223.38489,46.5730247,26,1.557341
12006,12006,2022-03-30 22:21:16-04:00,60.0,100,100,60,60,100,100,0.968000054,1.008,3.3920002,3.42400026,1.0,1.008,1.016,3.3920002,3.26400018,0.504,0.6,0.528,0.992000043,1.016,1.016,26.0,25,25.5,15,23,25,1923.0769,2184.466,18.75,22.65625,17.96875,17.1875,14.0625,17.93269,18.0929489,28,29,27,27,27,26,33,4005.51782,4005.51782,4005.51782,4005.51782,4005.51782,4005.51782,34.1241341,22.2940922,10.513464,3.085286,100.137947,56.17023,8.898327,6.943386,99,2207.40063,81.5004,25,1.52787137,100,1223.38489,46.5730247,26,1.557341
12007,12007,2022-03-30 22:21:17-04:00,60.0,100,100,60,60,100,100,0.968000054,1.008,3.3920002,3.40800023,1.0,1.008,1.008,3.3920002,3.26400018,0.496000022,0.6,0.528,0.992000043,1.016,1.016,26.0,25,25.5,15,23,25,1912.18127,2184.466,20.3125,22.65625,25.78125,15.625,18.75,19.53125,20.4427071,28,33,25,27,27,25,33,4005.51685,4005.51685,4005.51685,4005.51685,4005.51685,4005.51685,31.404398,19.6236534,10.5602942,2.9338572,100.137924,56.1240463,8.89101,6.95070267,99,2207.40063,81.5004,25,1.52787137,100,1223.38489,46.5730247,26,1.557341
12008,12008,2022-03-30 22:21:18-04:00,60.0,100,100,60,60,100,100,0.952,1.008,3.3920002,3.40800023,1.0,1.008,1.016,3.3920002,3.26400018,0.504,0.6,0.528,0.992000043,1.016,1.016,26.0,25,25.5,15,23,25,1912.18127,2184.466,14.0625,26.5625,14.84375,8.59375,12.5,28.90625,17.578125,31,33,26,27,27,27,33,4005.51685,4005.51685,4005.51685,4005.51685,4005.51685,4005.51685,32.6074028,20.8188171,10.5306082,3.00848246,100.137917,56.6494522,8.974243,6.86747,99,2207.40063,81.5004,25,1.52787137,100,1223.38489,46.5730247,26,1.557341
12009,12009,2022-03-30 22:21:19-04:00,60.0,100,100,60,60,100,100,0.9760001,1.008,3.3920002,3.40800023,1.0,1.008,1.008,3.3920002,3.26400018,0.504,0.6,0.528,0.992000043,1.016,1.016,26.0,25,25.5,15,23,25,1923.0769,2184.466,11.71875,17.96875,18.75,28.90625,12.5,17.1875,17.8385429,27,28,27,27,26,26,31,4005.518,4005.518,4005.518,4005.518,4005.518,4005.518,33.1977921,21.4539223,10.4555416,3.11955619,100.137947,57.69698,9.14019,6.701523,99,2207.40063,81.5004,25,1.52787137,100,1223.38489,46.5730247,26,1.557341
12010,12010,2022-03-30 22:21:20-04:00,60.0,100,100,60,60,100,100,0.952,1.008,3.3920002,3.42400026,1.0,1.008,1.008,3.3920002,3.26400018,0.496000022,0.6,0.528,0.992000043,1.016,1.016,26.5,25,25.5,15,23,25,1925.82031,2180.937,6.92307949,13.9543295,15.3846149,6.92307949,16.1538486,9.230768,11.4282846,24,25,25,25,31,25,31,4005.51685,4005.51685,4005.51685,4005.51685,4005.51685,4005.51685,25.3551826,14.29613,9.89057,2.62575841,100.137924,57.8858643,9.170113,6.67160034,99,2207.40063,81.5004,25,1.52787137,100,1223.38489,46.5730247,26,1.557341
12011,12011,2022-03-30 22:21:21-04:00,60.0,100,100,60,60,100,100,1.0,1.008,3.3920002,3.40800023,1.0,1.008,1.008,3.3920002,3.26400018,0.504,0.6,0.528,0.992000043,1.008,1.016,26.0,25,25.5,15,23,25,1934.09741,2177.41943,17.1875,23.2091312,35.15625,21.875,28.90625,30.46875,26.1338177,32,31,31,30,29,32,33,4005.51758,4005.51758,4005.51758,4005.51758,4005.51758,4005.51758,38.24495,29.03973,7.93612,3.03804374,100.137939,55.70433,8.82452,7.017193,99,2207.40063,81.5004,25,1.52787137,100,1223.38489,46.5730247,26,1.557341
12012,12012,2022-03-30 22:21:22-04:00,60.0,100,100,60,60,100,100,1.016,1.008,3.3920002,3.40800023,1.0,1.008,1.008,3.3920002,3.26400018,0.496000022,0.6,0.528,0.992000043,1.016,1.016,26.5,25,25.5,15,23,25,1923.0769,2180.937,19.23077,15.3846149,22.3076935,11.68269,18.4615364,29.4591312,19.4210777,26,26,25,26,26,27,34,4005.517,4005.517,4005.517,4005.517,4005.517,4005.517,33.4994,22.21932,9.879507,3.26165533,100.137932,57.4021,9.093475,6.74823761,99,2207.40063,81.5004,25,1.52787137,100,1223.38489,46.5730247,26,1.557341
12013,12013,2022-03-30 22:21:23-04:00,60.0,100,100,60,60,100,100,1.008,1.008,3.3920002,3.42400026,1.0,1.008,1.008,3.3920002,3.26400018,0.496000022,0.6,0.528,0.992000043,1.008,1.016,26.5,25,25.5,15,23,25,1923.0769,2184.466,14.0625,7.8125,13.28125,6.947112,10.15625,18.7019234,11.8269262,28,27,26,27,31,27,31,4005.51685,4005.51685,4005.51685,4005.51685,4005.51685,4005.51685,31.4569511,20.1253262,10.0599594,3.041676,100.137924,58.1166954,9.20668,6.63503265,99,2207.40063,81.5004,25,1.52787137,100,1223.38489,46.5730247,26,1.557341
12014,12014,2022-03-30 22:21:24-04:00,60.0,100,100,60,60,100,100,1.0,1.008,3.3920002,3.40800023,1.0,1.008,1.008,3.3920002,3.26400018,0.496000022,0.6,0.528,0.992000043,1.016,1.016,26.5,25,25.5,15,23,25,1912.18127,2184.466,20.3125,23.4375,16.40625,16.40625,17.96875,21.09375,19.2708321,28,28,27,27,33,27,33,4005.51758,4005.51758,4005.51758,4005.51758,4005.51758,4005.51758,35.77139,24.288866,10.0962019,3.32023978,100.137939,59.2251778,9.382282,6.45943069,99,2207.40063,81.5004,25,1.52787137,100,1223.38489,46.5730247,26,1.557341
12015,12015,2022-03-30 22:21:25-04:00,60.0,100,100,60,60,100,100,1.008,1.008,3.3920002,3.42400026,1.0,1.008,1.008,3.3920002,3.26400018,0.504,0.6,0.528,0.992000043,1.016,1.016,26.5,25,25.5,15,23,25,1925.82031,2184.466,16.2500019,18.4615364,12.3076916,12.3437519,10.0000019,18.4975986,14.6434307,25,26,25,26,26,29,32,4005.51758,4005.51758,4005.51758,4005.51758,4005.51758,4005.51758,33.42258,21.9645233,10.1562128,3.11112571,100.137939,59.990078,9.503456,6.338257,99,2207.40063,81.5004,25,1.52787137,100,1223.38489,46.5730247,26,1.557341
12016,12016,2022-03-30 22:21:26-04:00,60.0,100,100,60,60,100,100,0.832,1.008,3.3920002,3.42400026,1.0,1.008,1.008,3.3920002,3.26400018,0.496000022,0.6,0.528,0.992000043,1.016,1.016,26.5,25,25.5,15,23,25,1925.82031,2184.466,20.9375019,14.84375,14.84375,15.4807682,18.75,28.7860565,18.9403,30,27,30,34,29,29,35,4005.51685,4005.51685,4005.51685,4005.51685,4005.51685,4005.51685,33.2880249,21.7489166,10.19442,3.19409227,100.137924,62.0377769,9.827847,6.01386642,99,2207.40063,81.5004,25,1.52787137,100,1223.38489,46.5730247,26,1.557341
12017,12017,2022-03-30 22:21:27-04:00,60.0,100,100,60,60,100,100,0.8,1.008,3.3920002,3.42400026,1.0,1.008,1.008,3.3920002,3.26400018,0.504,0.6,0.528,0.992000043,1.016,1.016,26.5,25,25.5,15,23,25,1934.09741,2184.466,27.34375,17.96875,16.40625,16.40625,13.28125,18.75,18.359375,26,26,25,25,27,27,34,4005.51733,4005.51733,4005.51733,4005.51733,4005.51733,4005.51733,30.73233,19.2035427,10.3473167,2.88335371,100.137939,62.57009,9.912174,5.92953873,99,2207.40063,81.5004,25,1.52787137,100,1223.38489,46.5730247,26,1.557341
12018,12018,2022-03-30 22:21:28-04:00,60.0,100,100,60,60,100,100,0.928000033,1.008,3.3920002,3.40800023,1.0,1.008,1.008,3.3920002,3.26400018,0.504,0.6,0.528,0.992000043,1.016,1.016,26.5,25,25.5,15,23,25,1936.87231,2180.937,11.71875,14.84375,13.28125,7.8125,7.8125,19.53125,12.5,25,26,26,26,27,25,33,4005.51782,4005.51782,4005.51782,4005.51782,4005.51782,4005.51782,30.3627415,18.5977478,10.5110674,2.914131,100.137947,63.0255623,9.984329,5.85738373,99,2207.40063,81.5004,25,1.52787137,100,1223.38489,46.5730247,26,1.557341
12019,12019,2022-03-30 22:21:29-04:00,60.0,100,100,60,60,100,100,0.968000054,1.008,3.3920002,3.40800023,1.0,1.008,1.016,3.3920002,3.26400018,0.504,0.6,0.528,0.992000043,1.016,1.016,26.5,25,25.5,15,23,25,1936.87231,2184.466,21.09375,22.65625,25.0,18.75,16.40625,16.40625,20.0520821,32,28,32,28,31,27,32,4005.51685,4005.51685,4005.51685,4005.51685,4005.51685,4005.51685,32.9969635,21.31262,10.38009,3.164857,100.137917,62.8610268,9.958263,5.88344955,99,2207.40063,81.5004,25,1.52787137,100,1223.38489,46.5730247,26,1.557341
12020,12020,2022-03-30 22:21:30-04:00,60.0,100,100,60,60,100,100,0.872000039,1.008,3.3920002,3.40800023,1.0,1.008,1.008,3.3920002,3.26400018,0.496000022,0.6,0.528,0.992000043,1.016,1.016,26.5,25,25.5,15,23,25,1923.0769,2191.55835,11.71875,17.96875,14.84375,11.71875,10.9375,20.3125,14.5833311,25,25,24,25,26,25,33,2904.00024,4005.51758,4005.51758,4005.51758,4005.51758,2904.00024,27.4368362,15.9643745,10.23999,2.824901,100.137939,62.88443,9.961971,5.87974167,99,2207.40063,81.5004,25,1.52787137,100,1223.38489,46.5730247,26,1.557341
12021,12021,2022-03-30 22:21:31-04:00,60.0,100,100,60,60,100,100,0.768,1.008,3.3920002,3.42400026,1.0,1.008,1.008,3.3920002,3.26400018,0.504,0.6,0.528,0.992000043,1.016,1.016,26.5,25,25.5,15,23,25,1914.89368,2184.466,17.1875,19.53125,10.9375,12.5,7.8125,5.46875,12.2395811,30,28,27,31,29,29,31,4005.517,4005.517,4005.517,4005.517,4005.517,4005.517,28.11468,16.4437828,10.4321947,2.9361496,100.137924,62.8960876,9.963818,5.87789536,99,2207.40063,81.5004,25,1.52787137,100,1223.38489,46.5730247,26,1.557341
12022,12022,2022-03-30 22:21:32-04:00,60.0,100,100,60,60,100,100,1.0,1.008,3.3920002,3.42400026,1.0,1.008,1.008,3.3920002,3.26400018,0.496000022,0.6,0.528,0.992000043,1.016,1.016,26.5,25,25.5,15,23,25,1925.82031,2188.00659,8.65575,14.0997047,11.71875,10.2058525,9.375,10.255456,10.7184229,24,25,24,24,26,24,34,2904.00024,4005.51758,4005.51758,4005.51758,4005.51758,2904.00024,24.9245243,13.2049475,10.5429068,2.71758676,100.137939,62.93059,9.969284,5.872429,99,2207.40063,81.5004,25,1.52787137,100,1223.38489,46.5730247,26,1.557341
12023,12023,2022-03-30 22:21:33-04:00,60.0,100,100,60,60,100,100,0.960000038,1.008,3.3920002,3.42400026,1.0,1.008,1.008,3.3920002,3.26400018,0.504,0.6,0.528,0.992000043,1.016,1.016,26.5,25,25.5,15,23,25,1934.09741,2184.466,8.403265,9.195805,11.5384579,4.56876755,13.8461533,9.930068,9.580427,34,28,26,27,27,27,34,4005.5166,4005.5166,4005.5166,4005.5166,4005.5166,4005.5166,26.1505413,14.4604244,10.47211,2.85754228,100.137917,62.9451866,9.971596,5.870117,99,2207.40063,81.5004,25,1.52787137,100,1223.38489,46.5730247,26,1.557341
12024,12024,2022-03-30 22:21:34-04:00,60.0,100,100,60,60,100,100,0.968000054,1.008,3.3920002,3.40800023,1.0,1.008,1.008,3.3920002,3.26400018,0.496000022,0.6,0.528,0.992000043,1.008,1.016,26.5,25,25.5,15,23,25,1934.09741,2184.466,18.4615364,23.84615,18.4615364,16.2500019,20.7692261,13.9663458,18.6258011,25,25,24,24,25,24,30,4005.518,4005.518,4005.518,3705.10425,4005.518,4005.518,28.5713081,17.9483356,9.416676,2.838441,100.137955,66.4342,10.5243149,5.317398,99,2207.40063,81.5004,25,1.52787137,100,1223.38489,46.5730247,26,1.557341
12025,12025,2022-03-30 22:21:35-04:00,60.0,100,100,60,60,100,100,0.752000034,1.008,3.3920002,3.40800023,1.0,1.008,1.008,3.3920002,3.26400018,0.496000022,0.6,0.528,0.992000043,1.016,1.016,26.5,25,25.5,15,23,25,1923.0769,2184.466,19.53125,21.192955,12.5,12.4399071,17.1875,17.01923,16.64514,28,30,24,25,25,24,31,4005.51733,4005.51733,4005.51733,4005.51733,4005.51733,4005.51733,28.8263187,18.4835224,9.141545,2.80986071,100.137932,67.1517639,10.637989,5.203724,99,2207.40063,81.5004,25,1.52787137,100,1223.38489,46.5730247,26,1.557341
12026,12026,2022-03-30 22:21:36-04:00,60.0,100,100,60,60,100,100,0.984,1.008,3.3920002,3.40800023,1.0,1.008,1.008,3.3920002,3.26400018,0.496000022,0.6,0.528,0.992000043,1.008,1.016,26.5,25,25.5,15,23,25,1912.18127,2184.466,9.230768,20.7342625,8.4615345,9.230768,9.230768,9.230768,11.01982,24,25,24,24,26,24,30,4005.51758,4005.51758,4005.51758,4005.51758,4005.51758,2904.00024,24.4856033,14.1783876,9.133667,2.6995523,100.137939,66.97879,10.6105881,5.231125,99,2207.40063,81.5004,25,1.52787137,100,1223.38489,46.5730247,26,1.557341
12027,12027,2022-03-30 22:21:37-04:00,60.0,100,100,60,60,100,100,0.84800005,1.008,3.3920002,3.42400026,1.0,1.008,1.008,3.3920002,3.26400018,0.496000022,0.6,0.528,0.992000043,1.008,1.016,26.5,25,25.5,15,23,25,1912.18127,2184.466,14.0625,16.40625,17.96875,13.28125,17.96875,14.0625,15.625,25,26,25,25,27,26,31,4005.517,4005.517,4005.517,4005.517,4005.517,4005.517,27.4907017,17.1938324,9.102422,2.83135033,100.137932,66.9744339,10.6098976,5.23181534,99,2207.40063,81.5004,25,1.52787137,100,1223.38489,46.5730247,26,1.557341
12028,12028,2022-03-30 22:21:38-04:00,60.0,100,100,60,60,100,100,0.904000044,1.008,3.3920002,3.42400026,1.0,1.008,1.016,3.3920002,3.26400018,0.504,0.6,0.528,0.992000043,1.016,1.016,26.5,25,25.5,15,23,25,1925.82031,2184.466,17.96875,19.53125,10.15625,10.9375,10.9375,7.03125,12.7604189,29,27,27,31,28,26,31,4005.5166,4005.5166,4005.5166,4005.5166,4005.5166,4005.5166,26.6066761,16.1957226,9.199606,2.86551237,100.137917,67.10772,10.631012,5.210701,99,2207.40063,81.5004,25,1.52787137,100,1223.38489,46.5730247,26,1.557341
12029,12029,2022-03-30 22:21:39-04:00,60.0,100,100,60,60,100,100,0.9760001,1.008,3.3920002,3.42400026,1.0,1.008,1.008,3.3920002,3.26400018,0.496000022,0.6,0.528,0.992000043,1.016,1.016,26.5,25,25.5,15,23,25,1925.82031,2184.466,14.84375,7.03125,13.28125,8.59375,15.625,26.5625,14.3229189,26,26,25,25,26,26,30,4005.51831,4005.51831,4005.51831,4005.51831,4005.51831,4005.51831,29.6466026,19.4345589,8.990278,2.91736841,100.137955,68.4032745,10.83625,5.00546265,99,2207.40063,81.5004,25,1.52787137,100,1223.38489,46.5730247,26,1.557341
12030,12030,2022-03-30 22:21:40-04:00,60.0,100,100,60,60,100,100,1.0,1.008,3.3920002,3.42400026,1.0,1.008,1.008,3.3920002,3.26400018,0.496000022,0.6,0.528,0.992000043,1.016,1.016,26.5,25,25.5,15,23,25,1925.82031,2180.937,15.625,22.65625,10.15625,10.15625,11.71875,18.75,14.84375,26,26,24,25,27,25,30,4005.516,4005.516,4005.516,4005.516,4005.516,4005.516,27.71619,17.4238548,9.071486,2.88516641,100.1379,68.7541656,10.8918381,4.949875,99,2207.40063,81.5004,25,1.52787137,100,1223.38489,46.5730247,26,1.557341
12031,12031,2022-03-30 22:21:41-04:00,60.0,100,100,60,60,100,100,0.8880001,1.008,3.3920002,3.42400026,1.0,1.008,1.008,3.3920002,3.26400018,0.504,0.6,0.528,0.992000043,1.016,1.016,26.5,25,25.5,15,23,25,1936.87231,2184.466,14.84375,14.84375,12.5,10.9375,11.71875,14.0625,13.1510439,25,25,24,24,24,24,31,2904.00049,4005.51782,4005.51782,4005.51782,4005.51782,4005.51782,24.75992,14.402462,9.228522,2.66678119,100.137947,68.89468,10.9140968,4.927616,99,2207.40063,81.5004,25,1.52787137,100,1223.38489,46.5730247,26,1.557341
12032,12032,2022-03-30 22:21:42-04:00,60.0,100,100,60,60,100,100,0.928000033,1.008,3.3920002,3.42400026,1.0,1.008,1.008,3.3920002,3.26400018,0.504,0.6,0.528,0.992000043,1.016,1.016,26.5,25,25.5,15,23,25,1934.09741,2184.466,10.9375,12.5,9.375,7.8125,9.375,7.8125,9.635419,24,25,24,24,25,25,30,2903.99976,2903.99976,2903.99976,4005.51685,4005.51685,4005.51685,24.047987,13.7632618,9.146336,2.687814,100.137924,67.6008759,10.709137,5.132576,99,2207.40063,81.5004,25,1.52787137,100,1223.38489,46.5730247,26,1.557341
