,Time,Fan Control #1,Fan Control #2,Fan Control #3,Fan Control #4,Fan Control #5,Fan Control #6,Fan Control #7,CPU VCore,Voltage #2,AVCC,3VCC,Voltage #5,Voltage #6,Voltage #7,3VSB,VBAT,VTT,Voltage #11,Voltage #12,Voltage #13,Voltage #14,Voltage #15,Temperature #1,Temperature #2,Temperature #3,Temperature #4,Temperature #5,Temperature #6,Fan #2,Fan #3,CPU Core #1,CPU Core #2,CPU Core #3,CPU Core #4,CPU Core #5,CPU Core #6,CPU Total,CPU Core #1.1,CPU Core #2.1,CPU Core #3.1,CPU Core #4.1,CPU Core #5.1,CPU Core #6.1,CPU Package,CPU Core #1.2,CPU Core #2.2,CPU Core #3.2,CPU Core #4.2,CPU Core #5.2,CPU Core #6.2,CPU Package.1,CPU Cores,CPU Graphics,CPU DRAM,Bus Speed,Memory,Used Memory,Available Memory,Remaining Life,Total Bytes Written,Used Space,Temperature,Write Amplification,Remaining Life.1,Total Bytes Written.1,Used Space.1,Temperature.1,Write Amplification.1
12358,2022-03-30 22:27:11,60.0,100,100,60,60,100,100,0.9760001,1.008,3.3920002,3.42400026,1.0,1.008,1.016,3.3920002,3.26400018,0.496000022,0.6,0.528,0.992000043,1.016,1.016,26.0,26,25.5,15,23,25,1923.0769,2184.466,8.59375,14.84375,13.28125,14.84375,22.65625,19.53125,15.625,27,29,28,25,26,26,29,4005.51733,4005.51733,4005.51733,4005.51733,4005.51733,4005.51733,19.1711025,17.37989,0.8930676,1.78399432,100.137932,50.2263527,7.95671463,7.88499832,99,2207.54468,81.49962,26,1.52803171,100,1223.38513,46.5730247,26,1.5573411
12359,2022-03-30 22:27:12,60.0,100,100,60,60,100,100,0.968000054,1.008,3.3920002,3.42400026,1.0,1.008,1.016,3.3920002,3.26400018,0.496000022,0.6,0.528,0.992000043,1.016,1.016,26.0,26,25.5,15,23,25,1912.18127,2184.466,10.15625,14.0625,12.5,18.75,24.21875,17.96875,16.2760429,27,26,35,32,26,25,35,4005.517,4005.517,4005.517,4005.517,4005.517,4005.517,22.349844,20.5587482,0.8472138,1.98594069,100.137932,50.01946,7.92393875,7.917774,99,2207.54468,81.49962,26,1.52803171,100,1223.38513,46.5730247,26,1.5573411
12360,2022-03-30 22:27:13,60.0,100,100,60,60,100,100,0.9760001,1.008,3.3920002,3.42400026,1.0,1.008,1.008,3.3920002,3.26400018,0.496000022,0.6,0.528,0.992000043,1.016,1.016,26.0,26,25.5,15,23,25,1925.82031,2184.466,10.15625,14.0625,12.5,15.625,21.09375,12.5,14.3229189,25,26,25,31,26,25,31,4005.51758,4005.51758,4005.51758,4005.51758,4005.51758,4005.51758,19.85066,18.0569515,0.8456273,1.90756655,100.137939,50.03075,7.925728,7.915985,99,2207.54468,81.49962,26,1.52803171,100,1223.38513,46.5730247,26,1.5573411
12361,2022-03-30 22:27:14,60.0,100,100,60,60,100,100,0.968000054,1.008,3.3920002,3.42400026,1.0,1.008,1.016,3.3920002,3.26400018,0.496000022,0.6,0.528,0.992000043,1.016,1.016,26.0,26,25.5,15,23,25,1925.82031,2184.466,13.3680582,16.46825,11.0243082,14.1121025,32.8125,18.067955,17.6421947,26,27,25,27,30,25,30,4005.517,4005.517,4005.517,4005.517,4005.517,4005.517,20.6197681,18.822155,0.851850033,1.96285212,100.137924,50.2700844,7.963642,7.878071,99,2207.54468,81.49962,26,1.52803171,100,1223.38513,46.5730247,26,1.5573411
12362,2022-03-30 22:27:15,60.0,100,100,60,60,100,100,1.0,1.008,3.3920002,3.42400026,1.0,1.008,1.016,3.3920002,3.26400018,0.496000022,0.6,0.528,0.992000043,1.016,1.016,26.0,26,25.5,15,23,25,1936.87231,2177.41943,13.1971121,12.4278841,17.0312519,10.1081734,30.46875,17.0913467,16.7207546,26,24,24,25,30,25,30,4005.51782,4005.51782,4005.51782,4005.51782,4005.51782,4005.51782,20.3567333,18.499588,0.886516631,1.98956013,100.137947,50.00176,7.921135,7.920578,99,2207.557,81.50417,26,1.5280298,100,1223.38525,46.5730247,26,1.5573411
12363,2022-03-30 22:27:16,60.0,100,100,60,60,100,100,0.952,1.008,3.3920002,3.42400026,1.0,1.008,1.016,3.3920002,3.26400018,0.496000022,0.6,0.528,0.992000043,1.008,1.016,26.0,26,25.5,15,23,25,1923.0769,2177.41943,14.0625,15.625,17.96875,15.625,29.6875,14.0625,17.8385429,26,26,26,25,29,26,29,4005.51685,4005.51685,4005.51685,4005.51685,4005.51685,4005.51685,21.6334286,17.48318,3.23003244,1.99629951,100.137924,50.2162857,7.95512,7.886593,99,2207.557,81.50417,26,1.5280298,100,1223.38525,46.5730247,26,1.5573411
12364,2022-03-30 22:27:17,60.0,100,100,60,60,100,100,0.9760001,1.008,3.3920002,3.42400026,1.0,1.008,1.008,3.3920002,3.26400018,0.496000022,0.6,0.528,0.992000043,1.016,1.016,26.0,26,25.5,15,23,25,1923.0769,2180.937,16.7832146,15.3846149,13.8461533,18.4615364,28.9160843,13.7412548,17.8554764,25,25,25,25,33,25,33,4005.517,4005.517,4005.517,4005.517,4005.517,4005.517,24.7436829,19.2577572,4.49184942,2.06404018,100.137932,50.27697,7.964733,7.87698,99,2207.557,81.50417,26,1.5280298,100,1223.38525,46.5730247,26,1.5573411
