,Time,Fan Control #1,Fan Control #2,Fan Control #3,Fan Control #4,Fan Control #5,Fan Control #6,Fan Control #7,CPU VCore,Voltage #2,AVCC,3VCC,Voltage #5,Voltage #6,Voltage #7,3VSB,VBAT,VTT,Voltage #11,Voltage #12,Voltage #13,Voltage #14,Voltage #15,Temperature #1,Temperature #2,Temperature #3,Temperature #4,Temperature #5,Temperature #6,Fan #2,Fan #3,CPU Core #1,CPU Core #2,CPU Core #3,CPU Core #4,CPU Core #5,CPU Core #6,CPU Total,CPU Core #1.1,CPU Core #2.1,CPU Core #3.1,CPU Core #4.1,CPU Core #5.1,CPU Core #6.1,CPU Package,CPU Core #1.2,CPU Core #2.2,CPU Core #3.2,CPU Core #4.2,CPU Core #5.2,CPU Core #6.2,CPU Package.1,CPU Cores,CPU Graphics,CPU DRAM,Bus Speed,Memory,Used Memory,Available Memory,Remaining Life,Total Bytes Written,Used Space,Temperature,Write Amplification,Remaining Life.1,Total Bytes Written.1,Used Space.1,Temperature.1,Write Amplification.1
11817,2022-03-30 22:18:05,60.0,100,100,60,60,100,100,0.9760001,1.008,3.3920002,3.42400026,1.0,1.008,1.016,3.3920002,3.26400018,0.496000022,0.6,0.528,0.992000043,1.016,1.016,26.0,25,25.5,15,23,25,1925.82031,2184.466,13.28125,17.96875,7.8125,14.7716341,21.875,18.75,15.74319,30,25,25,25,25,25,30,4005.51685,4005.51685,4005.51685,4005.51685,4005.51685,4005.51685,18.1634789,16.4705982,0.8186077,1.71976352,100.137917,47.52454,7.528702,8.313011,99,2207.32666,81.49985,25,1.52788031,100,1223.38464,46.5730247,26,1.557341
11818,2022-03-30 22:18:06,60.0,100,100,60,60,100,100,0.960000038,1.008,3.3920002,3.42400026,1.0,1.008,1.008,3.3920002,3.26400018,0.496000022,0.6,0.528,0.992000043,1.016,1.016,26.0,25,25.5,15,23,25,1936.87231,2184.466,17.1875,31.25,13.28125,17.1875,17.96875,16.40625,18.8802071,25,25,24,25,32,25,32,4005.51758,4005.51758,4005.51758,4005.51758,4005.51758,4005.51758,20.390522,18.5884266,0.8438684,1.988492,100.137939,47.6809425,7.55347824,8.288235,99,2207.32666,81.49985,25,1.52788031,100,1223.38464,46.5730247,26,1.557341
11819,2022-03-30 22:18:07,60.0,100,100,60,60,100,100,0.952,1.008,3.3920002,3.42400026,1.0,1.008,1.016,3.3920002,3.26400018,0.496000022,0.6,0.528,0.992000043,1.016,1.016,26.0,25,25.5,15,23,25,1934.09741,2184.466,6.153846,13.0769253,19.9999981,9.230768,18.4615364,14.6153812,13.5897341,27,25,24,25,25,29,30,4005.51733,4005.51733,4005.51733,4005.51733,4005.51733,4005.51733,19.0815086,17.34215,0.829335,1.84213114,100.137932,47.74442,7.563534,8.278179,99,2207.32666,81.49985,25,1.52788031,100,1223.38464,46.5730247,26,1.557341
11820,2022-03-30 22:18:08,60.0,100,100,60,60,100,100,0.968000054,1.008,3.3920002,3.42400026,1.0,1.008,1.008,3.3920002,3.26400018,0.504,0.6,0.528,0.992000043,1.008,1.016,26.0,25,25.5,15,23,25,1923.0769,2184.466,14.84375,17.96875,10.9375,16.40625,25.0,20.3125,17.578125,30,30,27,30,29,27,30,4005.5166,4005.5166,4005.5166,4005.5166,4005.5166,4005.5166,20.29067,18.4918613,0.837112546,1.972287,100.137909,47.773365,7.568119,8.273594,99,2207.32666,81.49985,25,1.52788031,100,1223.38464,46.5730247,26,1.557341
11821,2022-03-30 22:18:09,60.0,100,100,60,60,100,100,0.9760001,1.008,3.3920002,3.42400026,1.0,1.008,1.008,3.3920002,3.26400018,0.496000022,0.6,0.528,0.992000043,1.016,1.016,26.0,25,25.5,15,23,25,1912.18127,2184.466,9.375,17.1875,10.15625,9.375,21.09375,20.3125,14.5833311,24,26,26,24,32,24,32,4005.51782,4005.51782,4005.51782,4005.51782,4005.51782,4005.51782,19.3559418,16.1149864,2.33782578,1.88377535,100.137947,47.7567253,7.565483,8.27623,99,2207.32666,81.49985,25,1.52788031,100,1223.38464,46.5730247,26,1.557341
11822,2022-03-30 22:18:10,60.0,100,100,60,60,100,100,0.992000043,1.008,3.3920002,3.42400026,1.0,1.008,1.016,3.3920002,3.26400018,0.496000022,0.6,0.528,0.992000043,1.016,1.016,26.0,25,25.5,15,23,25,1912.18127,2184.466,9.230768,7.69230747,16.2019253,3.076923,23.0769215,21.53846,13.469553,27,30,32,25,26,26,32,4005.51758,4005.51758,4005.51758,4005.51758,4005.51758,4005.51758,22.2907887,18.0254955,3.311161,2.03790474,100.137939,47.86022,7.58187866,8.259834,99,2207.32666,81.49985,25,1.52788031,100,1223.38464,46.5730247,26,1.557341
11823,2022-03-30 22:18:11,60.0,100,100,60,60,100,100,0.960000038,1.008,3.3920002,3.42400026,1.0,1.008,1.016,3.3920002,3.26400018,0.496000022,0.6,0.528,0.992000043,1.016,1.016,26.0,25,25.5,15,23,25,1925.82031,2184.466,15.3846149,19.23077,16.8648,15.3846149,20.7692261,12.3076916,16.6569538,24,26,25,31,25,26,31,4005.51758,4005.51758,4005.51758,4005.51758,4005.51758,4005.51758,22.6054058,18.4259167,3.248453,1.94233227,100.137939,47.9807434,7.600971,8.240742,99,2207.32666,81.49985,25,1.52788031,100,1223.38464,46.5730247,26,1.557341
