,Time,Fan Control #1,Fan Control #2,Fan Control #3,Fan Control #4,Fan Control #5,Fan Control #6,Fan Control #7,CPU VCore,Voltage #2,AVCC,3VCC,Voltage #5,Voltage #6,Voltage #7,3VSB,VBAT,VTT,Voltage #11,Voltage #12,Voltage #13,Voltage #14,Voltage #15,Temperature #1,Temperature #2,Temperature #3,Temperature #4,Temperature #5,Temperature #6,Fan #2,Fan #3,CPU Core #1,CPU Core #2,CPU Core #3,CPU Core #4,CPU Core #5,CPU Core #6,CPU Total,CPU Core #1.1,CPU Core #2.1,CPU Core #3.1,CPU Core #4.1,CPU Core #5.1,CPU Core #6.1,CPU Package,CPU Core #1.2,CPU Core #2.2,CPU Core #3.2,CPU Core #4.2,CPU Core #5.2,CPU Core #6.2,CPU Package.1,CPU Cores,CPU Graphics,CPU DRAM,Bus Speed,Memory,Used Memory,Available Memory,Remaining Life,Total Bytes Written,Used Space,Temperature,Write Amplification,Remaining Life.1,Total Bytes Written.1,Used Space.1,Temperature.1,Write Amplification.1
12494,2022-03-30 22:29:27,60.0,100,100,60,60,100,100,0.9760001,1.008,3.3920002,3.42400026,1.0,1.008,1.008,3.3920002,3.26400018,0.496000022,0.6,0.528,0.992000043,1.016,1.016,26.0,26,25.5,15,23,25,1923.0769,2180.937,12.5,15.625,11.71875,14.942956,18.75,13.28125,14.4696531,26,26,25,31,26,25,31,4005.51685,4005.51685,4005.51685,4005.51685,4005.51685,4005.51685,18.8735142,17.0740585,0.916635454,1.73966551,100.137917,50.91608,8.065979,7.775734,99,2207.612,81.50006,25,1.52802479,100,1223.38538,46.5730247,26,1.557341
12495,2022-03-30 22:29:28,60.0,100,100,60,60,100,100,0.968000054,1.008,3.3920002,3.42400026,1.0,1.008,1.008,3.3920002,3.26400018,0.496000022,0.6,0.528,0.992000043,1.008,1.016,26.0,26,25.5,15,23,25,1912.18127,2184.466,10.9375,17.1875,16.40625,12.4158621,22.65625,12.5,15.3505621,24,25,24,25,25,30,30,4005.51782,4005.51782,4005.51782,4005.51782,4005.51782,4005.51782,19.886776,18.1287289,0.830356,1.883652,100.137947,51.0096054,8.080795,7.76091766,99,2207.612,81.50006,25,1.52802479,100,1223.38538,46.5730247,26,1.557341
12496,2022-03-30 22:29:29,60.0,100,100,60,60,100,100,0.984,1.008,3.3920002,3.42400026,1.0,1.008,1.008,3.3920002,3.26400018,0.496000022,0.6,0.528,0.992000043,1.016,1.016,26.0,26,25.5,15,23,25,1925.82031,2184.466,8.4615345,15.3846149,18.4615364,10.76923,19.23077,17.6923027,14.9999914,26,31,24,25,26,24,31,4005.5166,4005.5166,4005.5166,4005.5166,4005.5166,4005.5166,19.6785851,17.9208736,0.8339948,1.89980912,100.137917,51.13795,8.101128,7.74058533,99,2207.612,81.50006,25,1.52802479,100,1223.38538,46.5730247,26,1.557341
12497,2022-03-30 22:29:30,60.0,100,100,60,60,100,100,0.960000038,1.008,3.3920002,3.42400026,1.0,1.008,1.008,3.3920002,3.26400018,0.496000022,0.6,0.528,0.992000043,1.016,1.016,26.0,26,25.5,15,23,25,1925.82031,2184.466,12.5,24.21875,14.84375,16.40625,25.78125,14.0625,17.96875,26,25,25,25,33,24,33,4005.51758,4005.51758,4005.51758,4005.51758,4005.51758,4005.51758,20.0693836,18.2833061,0.834706843,1.95036292,100.137939,51.053093,8.087685,7.75402832,99,2207.612,81.50006,25,1.52802479,100,1223.38538,46.5730247,26,1.557341
12498,2022-03-30 22:29:31,60.0,100,100,60,60,100,100,0.9760001,1.008,3.3920002,3.42400026,1.0,1.008,1.016,3.3920002,3.26400018,0.496000022,0.6,0.528,0.992000043,1.016,1.016,26.0,26,25.5,15,23,25,1934.09741,2184.466,16.40625,10.9375,13.28125,9.375,17.1875,18.75,14.3229189,29,25,25,31,26,24,31,4005.51733,4005.51733,4005.51733,4005.51733,4005.51733,4005.51733,19.1344185,17.2022114,1.01816607,1.89796233,100.137932,51.08974,8.093491,7.74822235,99,2207.612,81.50006,25,1.52802479,100,1223.38538,46.5730247,26,1.557341
12499,2022-03-30 22:29:32,60.0,100,100,60,60,100,100,0.984,1.008,3.3920002,3.40800023,1.0,1.008,1.008,3.3920002,3.26400018,0.496000022,0.6,0.528,0.992000043,1.016,1.016,26.0,26,25.5,15,23,25,1923.0769,2180.937,11.5384579,15.3846149,18.4615364,8.4615345,29.4951916,13.8461533,16.1979141,29,26,26,26,30,28,30,4005.51733,4005.51733,4005.51733,4005.51733,4005.51733,4005.51733,23.08843,18.3460083,3.761408,2.05314469,100.137932,51.10903,8.096546,7.745167,99,2207.612,81.50006,25,1.52802479,100,1223.38538,46.5730247,26,1.557341
12500,2022-03-30 22:29:33,60.0,100,100,60,60,100,100,0.9760001,1.008,3.3920002,3.42400026,1.0,1.008,1.016,3.3920002,3.26400018,0.496000022,0.6,0.528,0.992000043,1.008,1.016,26.0,26,25.5,15,23,25,1923.0769,2184.466,16.9230766,17.6923027,15.3846149,11.3636379,24.061512,18.939394,17.3940887,25,25,24,25,33,25,33,4005.51758,4005.51758,4005.51758,4005.51758,4005.51758,4005.51758,23.1694889,17.5820217,4.66366339,1.93043983,100.137939,51.2674065,8.121635,7.72007751,99,2207.612,81.50006,25,1.52802479,100,1223.38538,46.5730247,26,1.557341
12501,2022-03-30 22:29:34,60.0,100,100,60,60,100,100,0.960000038,1.008,3.3920002,3.42400026,1.0,1.008,1.008,3.3920002,3.26400018,0.496000022,0.6,0.528,0.992000043,1.016,1.016,26.0,26,25.5,15,23,25,1912.18127,2184.466,8.59375,11.71875,10.9375,9.523809,29.3650742,12.6984119,13.8062239,24,24,24,24,25,31,31,4005.5166,4005.5166,4005.5166,4005.5166,4005.5166,4005.5166,22.6693649,16.83179,4.89242,1.93248928,100.137917,51.31147,8.128616,7.71309662,99,2207.612,81.50006,25,1.52802479,100,1223.38538,46.5730247,26,1.557341
